Index,File,Are equals,Size in baserom,Size in other_baserom,Size proportion,Size difference,Bytes different
0,makerom,False,4192,4192,1.0,0,17
1,boot,False,26864,73488,0.366,-46624,23321
2,dmadata,False,24432,24768,0.986,-336,18060
4,Audioseq,False,326272,326272,1.0,0,6112
7,icon_item_static,False,564384,564384,1.0,0,1951
20,nes_font_static,False,17792,17920,0.993,-128,0
22,ger_message_data_static,False,244128,244176,1.0,-48,221983
23,fra_message_data_static,False,226064,225728,1.001,336,211613
28,code,False,1053936,1290032,0.817,-236096,948758
29,ovl_title,False,76944,2960,25.995,73984,2666
30,ovl_select,False,2496,12384,0.202,-9888,2288
31,ovl_opening,False,11616,336,34.571,11280,300
32,ovl_file_choose,False,352,64192,0.005,-63840,327
33,ovl_kaleido_scope,False,67296,125312,0.537,-58016,62311
34,ovl_player_actor,False,117760,157840,0.746,-40080,106878
35,ovl_map_mark_data,False,157360,27360,5.751,130000,21438
36,ovl_En_Test,False,27488,22704,1.211,4784,17157
37,ovl_Arms_Hook,False,22704,3600,6.307,19104,3213
38,ovl_Arrow_Fire,False,10528,8128,1.295,2400,7647
39,ovl_Arrow_Ice,False,5648,8160,0.692,-2512,5197
40,ovl_Arrow_Light,False,3568,8176,0.436,-4608,3283
41,ovl_Bg_Bdan_Objects,False,3648,4976,0.733,-1328,3280
42,ovl_Bg_Bdan_Switch,False,6960,5440,1.279,1520,4926
43,ovl_Bg_Bom_Guard,False,16784,640,26.225,16144,564
44,ovl_Bg_Bombwall,False,9696,2448,3.961,7248,2192
45,ovl_Bg_Bowl_Wall,False,3792,2688,1.411,1104,2452
46,ovl_Bg_Breakwall,False,6672,3792,1.759,2880,3386
47,ovl_Bg_Ddan_Jd,False,11680,1600,7.3,10080,1486
48,ovl_Bg_Ddan_Kd,False,8560,2320,3.69,6240,2083
49,ovl_Bg_Dodoago,False,49760,3520,14.136,46240,3151
50,ovl_Bg_Dy_Yoseizo,False,5872,12528,0.469,-6656,5387
51,ovl_Bg_Ganon_Otyuka,False,18880,10304,1.832,8576,9784
52,ovl_Bg_Gate_Shutter,False,13104,1376,9.523,11728,1248
53,ovl_Bg_Gjyo_Bridge,False,11680,1392,8.391,10288,1242
54,ovl_Bg_Gnd_Darkmeiro,False,6768,2192,3.088,4576,2000
55,ovl_Bg_Gnd_Firemeiro,False,14080,1504,9.362,12576,1384
56,ovl_Bg_Gnd_Iceblock,False,4048,4512,0.897,-464,3614
57,ovl_Bg_Gnd_Nisekabe,False,304,368,0.826,-64,246
58,ovl_Bg_Gnd_Soulmeiro,False,27376,2288,11.965,25088,2038
59,ovl_Bg_Haka,False,1424,1856,0.767,-432,1259
60,ovl_Bg_Haka_Gate,False,39648,4544,8.725,35104,4237
61,ovl_Bg_Haka_Huta,False,24448,2688,9.095,21760,2466
62,ovl_Bg_Haka_Megane,False,15872,1008,15.746,14864,912
63,ovl_Bg_Haka_MeganeBG,False,11952,1712,6.981,10240,1537
64,ovl_Bg_Haka_Sgami,False,11408,3104,3.675,8304,2830
65,ovl_Bg_Haka_Ship,False,768,2976,0.258,-2208,675
66,ovl_Bg_Haka_Trap,False,5152,5552,0.928,-400,4663
67,ovl_Bg_Haka_Tubo,False,8832,2736,3.228,6096,2470
68,ovl_Bg_Haka_Water,False,7840,2240,3.5,5600,2017
69,ovl_Bg_Haka_Zou,False,2960,4560,0.649,-1600,2684
70,ovl_Bg_Heavy_Block,False,2240,6672,0.336,-4432,2013
71,ovl_Bg_Hidan_Curtain,False,10080,3200,3.15,6880,2942
72,ovl_Bg_Hidan_Dalm,False,8912,2112,4.22,6800,1902
73,ovl_Bg_Hidan_Firewall,False,7760,2016,3.849,5744,1839
74,ovl_Bg_Hidan_Fslift,False,11376,1200,9.48,10176,1082
75,ovl_Bg_Hidan_Fwbig,False,13168,3408,3.864,9760,3158
76,ovl_Bg_Hidan_Hamstep,False,7264,4336,1.675,2928,3973
77,ovl_Bg_Hidan_Hrock,False,2448,2096,1.168,352,1854
78,ovl_Bg_Hidan_Kousi,False,9760,1728,5.648,8032,1591
79,ovl_Bg_Hidan_Kowarerukabe,False,26080,4192,6.221,21888,3772
80,ovl_Bg_Hidan_Rock,False,5728,4480,1.279,1248,4040
81,ovl_Bg_Hidan_Rsekizou,False,3392,3264,1.039,128,2922
82,ovl_Bg_Hidan_Sekizou,False,2128,5392,0.395,-3264,1941
83,ovl_Bg_Hidan_Sima,False,2096,4080,0.514,-1984,1885
84,ovl_Bg_Hidan_Syoku,False,3456,1104,3.13,2352,1004
85,ovl_Bg_Ice_Objects,False,4336,3888,1.115,448,3592
86,ovl_Bg_Ice_Shelter,False,3040,4992,0.609,-1952,2775
87,ovl_Bg_Ice_Shutter,False,5200,1120,4.643,4080,1005
88,ovl_Bg_Ice_Turara,False,3872,2080,1.862,1792,1856
89,ovl_Bg_Ingate,False,1120,1056,1.061,64,922
90,ovl_Bg_Jya_1flift,False,26464,1888,14.017,24576,1699
91,ovl_Bg_Jya_Amishutter,False,2720,1056,2.576,1664,950
92,ovl_Bg_Jya_Bigmirror,False,4368,2752,1.587,1616,2531
93,ovl_Bg_Jya_Block,False,16912,768,22.021,16144,715
94,ovl_Bg_Jya_Bombchuiwa,False,5232,3328,1.572,1904,3015
95,ovl_Bg_Jya_Bombiwa,False,1888,1872,1.009,16,1629
96,ovl_Bg_Jya_Cobra,False,11776,8320,1.415,3456,7701
97,ovl_Bg_Jya_Goroiwa,False,18224,1872,9.735,16352,1702
98,ovl_Bg_Jya_Haheniron,False,1232,2016,0.611,-784,1098
99,ovl_Bg_Jya_Ironobj,False,224,3744,0.06,-3520,185
100,ovl_Bg_Jya_Kanaami,False,1968,1120,1.757,848,1019
101,ovl_Bg_Jya_Lift,False,1760,1424,1.236,336,1272
102,ovl_Bg_Jya_Megami,False,19824,4880,4.062,14944,4479
103,ovl_Bg_Jya_Zurerukabe,False,9216,2096,4.397,7120,1927
104,ovl_Bg_Menkuri_Eye,False,15008,1328,11.301,13680,1184
105,ovl_Bg_Menkuri_Kaiten,False,416,384,1.083,32,273
106,ovl_Bg_Menkuri_Nisekabe,False,5616,336,16.714,5280,299
107,ovl_Bg_Mizu_Bwall,False,1616,6064,0.266,-4448,1492
108,ovl_Bg_Mizu_Movebg,False,3696,4624,0.799,-928,3306
109,ovl_Bg_Mizu_Shutter,False,5584,2192,2.547,3392,2010
110,ovl_Bg_Mizu_Uzu,False,2800,464,6.034,2336,422
111,ovl_Bg_Mizu_Water,False,2288,3792,0.603,-1504,2092
112,ovl_Bg_Mjin,False,17056,1088,15.676,15968,993
113,ovl_Bg_Mori_Bigst,False,3120,3136,0.995,-16,2770
114,ovl_Bg_Mori_Elevator,False,1008,3424,0.294,-2416,901
115,ovl_Bg_Mori_Hashigo,False,6144,2816,2.182,3328,2545
116,ovl_Bg_Mori_Hashira4,False,400,1888,0.212,-1488,347
117,ovl_Bg_Mori_Hineri,False,1168,3696,0.316,-2528,1029
118,ovl_Bg_Mori_Idomizu,False,9888,1920,5.15,7968,1745
119,ovl_Bg_Mori_Kaitenkabe,False,4496,1968,2.285,2528,1800
120,ovl_Bg_Mori_Rakkatenjo,False,3280,3232,1.015,48,2864
121,ovl_Bg_Po_Event,False,3424,7824,0.438,-4400,3075
122,ovl_Bg_Po_Syokudai,False,10544,2608,4.043,7936,2412
123,ovl_Bg_Pushbox,False,3328,880,3.782,2448,776
124,ovl_Bg_Relay_Objects,False,15568,1936,8.041,13632,1769
125,ovl_Bg_Spot00_Break,False,3488,416,8.385,3072,364
126,ovl_Bg_Spot00_Hanebasi,False,1552,4672,0.332,-3120,1401
127,ovl_Bg_Spot01_Fusya,False,5712,800,7.14,4912,733
128,ovl_Bg_Spot01_Idohashira,False,9760,3584,2.723,6176,3278
129,ovl_Bg_Spot01_Idomizu,False,992,928,1.069,64,813
130,ovl_Bg_Spot01_Idosoko,False,1408,704,2.0,704,618
131,ovl_Bg_Spot01_Objects2,False,352,1312,0.268,-960,306
132,ovl_Bg_Spot02_Objects,False,3760,5248,0.716,-1488,3385
133,ovl_Bg_Spot03_Taki,False,1216,2448,0.497,-1232,1097
134,ovl_Bg_Spot05_Soko,False,4560,784,5.816,3776,699
135,ovl_Bg_Spot06_Objects,False,1152,5296,0.218,-4144,1034
136,ovl_Bg_Spot07_Taki,False,832,1696,0.491,-864,725
137,ovl_Bg_Spot08_Bakudankabe,False,4768,1680,2.838,3088,1486
138,ovl_Bg_Spot08_Iceblock,False,336,4480,0.075,-4144,298
139,ovl_Bg_Spot09_Obj,False,256,1696,0.151,-1440,205
140,ovl_Bg_Spot11_Bakudankabe,False,14784,1648,8.971,13136,1511
141,ovl_Bg_Spot11_Oasis,False,7728,1952,3.959,5776,1741
142,ovl_Bg_Spot12_Gate,False,2352,1168,2.014,1184,1041
143,ovl_Bg_Spot12_Saku,False,2800,1344,2.083,1456,1224
144,ovl_Bg_Spot15_Rrbox,False,1632,3824,0.427,-2192,1460
145,ovl_Bg_Spot15_Saku,False,2416,992,2.435,1424,901
146,ovl_Bg_Spot16_Bombstone,False,6320,6160,1.026,160,5526
147,ovl_Bg_Spot16_Doughnut,False,23296,1920,12.133,21376,1806
148,ovl_Bg_Spot17_Bakudankabe,False,15536,2112,7.356,13424,1929
149,ovl_Bg_Spot17_Funen,False,3296,784,4.204,2512,720
150,ovl_Bg_Spot18_Basket,False,13280,4208,3.156,9072,3871
151,ovl_Bg_Spot18_Futa,False,5392,400,13.48,4992,363
152,ovl_Bg_Spot18_Obj,False,10416,2752,3.785,7664,2491
153,ovl_Bg_Spot18_Shutter,False,19696,1344,14.655,18352,1212
154,ovl_Bg_Sst_Floor,False,6384,1520,4.2,4864,1379
155,ovl_Bg_Toki_Hikari,False,7728,3904,1.98,3824,3545
156,ovl_Bg_Toki_Swd,False,4112,5824,0.706,-1712,3475
157,ovl_Bg_Treemouth,False,14192,5856,2.423,8336,5225
158,ovl_Bg_Umajump,False,29488,384,76.792,29104,322
159,ovl_Bg_Vb_Sima,False,12832,1952,6.574,10880,1784
160,ovl_Bg_Ydan_Hasi,False,6816,2112,3.227,4704,1910
161,ovl_Bg_Ydan_Maruta,False,11456,1744,6.569,9712,1511
162,ovl_Bg_Ydan_Sp,False,7680,6160,1.247,1520,5609
163,ovl_Bg_Zg,False,1648,1392,1.184,256,1269
164,ovl_Boss_Dodongo,False,4944,39984,0.124,-35040,4563
165,ovl_Boss_Fd,False,1728,30896,0.056,-29168,1564
166,ovl_Boss_Fd2,False,7424,16896,0.439,-9472,7066
167,ovl_Boss_Ganon,False,8912,142160,0.063,-133248,8529
168,ovl_Boss_Ganon2,False,30368,72672,0.418,-42304,28069
169,ovl_Boss_Ganondrof,False,15664,21456,0.73,-5792,14476
170,ovl_Boss_Goma,False,3344,24816,0.135,-21472,3061
171,ovl_Boss_Mo,False,6864,49088,0.14,-42224,6374
172,ovl_Boss_Sst,False,4096,50880,0.081,-46784,3754
173,ovl_Boss_Tw,False,3808,80752,0.047,-76944,3349
174,ovl_Boss_Va,False,2912,60560,0.048,-57648,2633
175,ovl_Demo_6K,False,14304,12672,1.129,1632,11377
176,ovl_Demo_Du,False,16240,14816,1.096,1424,12685
177,ovl_Demo_Ec,False,1808,15008,0.12,-13200,1611
178,ovl_Demo_Effect,False,6064,25664,0.236,-19600,5542
179,ovl_Demo_Ext,False,1808,2736,0.661,-928,1633
180,ovl_Demo_Geff,False,4512,2800,1.611,1712,2596
181,ovl_Demo_Gj,False,1024,16192,0.063,-15168,927
182,ovl_Demo_Go,False,1728,3584,0.482,-1856,1562
183,ovl_Demo_Gt,False,2624,23696,0.111,-21072,2349
184,ovl_Demo_Ik,False,3104,6368,0.487,-3264,2804
185,ovl_Demo_Im,False,8704,17056,0.51,-8352,7865
186,ovl_Demo_Kankyo,False,4656,16640,0.28,-11984,4273
187,ovl_Demo_Kekkai,False,4368,5264,0.83,-896,3995
188,ovl_Demo_Sa,False,4336,11728,0.37,-7392,3912
189,ovl_Demo_Shd,False,6336,9360,0.677,-3024,5829
190,ovl_Demo_Tre_Lgt,False,1296,2096,0.618,-800,1174
191,ovl_Door_Ana,False,2256,1776,1.27,480,1571
192,ovl_Door_Gerudo,False,59376,1648,36.029,57728,1497
193,ovl_Door_Killer,False,2592,5712,0.454,-3120,2330
194,ovl_Door_Shutter,False,5584,9088,0.614,-3504,5044
195,ovl_Door_Toki,False,2720,352,7.727,2368,304
196,ovl_Door_Warp1,False,4592,17696,0.259,-13104,4200
197,ovl_Efc_Erupc,False,592,3104,0.191,-2512,532
198,ovl_Eff_Dust,False,3488,5344,0.653,-1856,3228
199,ovl_Effect_Ss_Blast,False,3520,1024,3.438,2496,932
200,ovl_Effect_Ss_Bomb,False,672,1184,0.568,-512,601
201,ovl_Effect_Ss_Bomb2,False,17872,2544,7.025,15328,2320
202,ovl_Effect_Ss_Bubble,False,46496,1296,35.877,45200,1170
203,ovl_Effect_Ss_D_Fire,False,5184,1360,3.812,3824,1212
204,ovl_Effect_Ss_Dead_Db,False,11024,1344,8.202,9680,1232
205,ovl_Effect_Ss_Dead_Dd,False,6384,1584,4.03,4800,1426
206,ovl_Effect_Ss_Dead_Ds,False,4816,1312,3.671,3504,1182
207,ovl_Effect_Ss_Dead_Sound,False,11040,384,28.75,10656,304
208,ovl_Effect_Ss_Dt_Bubble,False,3424,1568,2.184,1856,1398
209,ovl_Effect_Ss_Dust,False,11680,2192,5.328,9488,1993
210,ovl_Effect_Ss_En_Fire,False,6400,2000,3.2,4400,1795
211,ovl_Effect_Ss_En_Ice,False,5440,2448,2.222,2992,2207
212,ovl_Effect_Ss_Extra,False,3792,1120,3.386,2672,1005
213,ovl_Effect_Ss_Fcircle,False,2240,1344,1.667,896,1215
214,ovl_Effect_Ss_Fhg_Flash,False,11648,4320,2.696,7328,3785
215,ovl_Effect_Ss_Fire_Tail,False,1600,1936,0.826,-336,1412
216,ovl_Effect_Ss_G_Fire,False,464,640,0.725,-176,401
217,ovl_Effect_Ss_G_Magma,False,5136,592,8.676,4544,528
218,ovl_Effect_Ss_G_Magma2,False,3904,1472,2.652,2432,1324
219,ovl_Effect_Ss_G_Ripple,False,2016,1488,1.355,528,1317
220,ovl_Effect_Ss_G_Spk,False,4192,1552,2.701,2640,1373
221,ovl_Effect_Ss_G_Splash,False,5792,1200,4.827,4592,1068
222,ovl_Effect_Ss_Hahen,False,4304,1888,2.28,2416,1718
223,ovl_Effect_Ss_HitMark,False,77952,1456,53.538,76496,1274
224,ovl_Effect_Ss_Ice_Piece,False,9520,1264,7.532,8256,1185
225,ovl_Effect_Ss_Ice_Smoke,False,7888,1472,5.359,6416,1370
226,ovl_Effect_Ss_K_Fire,False,2800,1232,2.273,1568,1096
227,ovl_Effect_Ss_Kakera,False,4784,4496,1.064,288,4095
228,ovl_Effect_Ss_KiraKira,False,3520,1760,2.0,1760,1585
229,ovl_Effect_Ss_Lightning,False,2240,1856,1.207,384,1680
230,ovl_Effect_Ss_Sibuki,False,1408,1840,0.765,-432,1277
231,ovl_Effect_Ss_Sibuki2,False,1600,976,1.639,624,882
232,ovl_Effect_Ss_Solder_Srch_Ball,False,1456,416,3.5,1040,370
233,ovl_Effect_Ss_Stick,False,5168,1072,4.821,4096,957
234,ovl_Effect_Ss_Stone1,False,4832,1056,4.576,3776,934
235,ovl_Elf_Msg,False,139872,3040,46.011,136832,2698
236,ovl_Elf_Msg2,False,50464,2080,24.262,48384,1917
237,ovl_En_Am,False,6448,9296,0.694,-2848,5825
238,ovl_En_Ani,False,10896,3504,3.11,7392,3198
239,ovl_En_Anubice,False,2576,5248,0.491,-2672,2364
240,ovl_En_Anubice_Fire,False,4656,3680,1.265,976,3339
241,ovl_En_Anubice_Tag,False,4592,976,4.705,3616,871
242,ovl_En_Arow_Trap,False,2000,336,5.952,1664,298
243,ovl_En_Arrow,False,6224,6112,1.018,112,5605
244,ovl_En_Attack_Niw,False,11536,4688,2.461,6848,4319
245,ovl_En_Ba,False,720,8080,0.089,-7360,643
246,ovl_En_Bb,False,4224,15696,0.269,-11472,3852
247,ovl_En_Bdfire,False,832,3120,0.267,-2288,773
248,ovl_En_Bigokuta,False,1920,11328,0.169,-9408,1754
249,ovl_En_Bili,False,1712,8976,0.191,-7264,1570
250,ovl_En_Bird,False,7456,1200,6.213,6256,1095
251,ovl_En_Blkobj,False,944,1648,0.573,-704,833
252,ovl_En_Bom,False,80304,3936,20.402,76368,3551
253,ovl_En_Bom_Bowl_Man,False,6832,6160,1.109,672,5645
254,ovl_En_Bom_Bowl_Pit,False,1152,2544,0.453,-1392,1063
255,ovl_En_Bom_Chu,False,5088,5936,0.857,-848,4672
256,ovl_En_Bombf,False,672,5408,0.124,-4736,610
257,ovl_En_Boom,False,3072,2368,1.297,704,2138
258,ovl_En_Box,False,784,7488,0.105,-6704,701
259,ovl_En_Brob,False,2384,4336,0.55,-1952,2146
260,ovl_En_Bubble,False,9792,5232,1.872,4560,4878
261,ovl_En_Butte,False,3552,5744,0.618,-2192,3235
262,ovl_En_Bw,False,400,13312,0.03,-12912,357
263,ovl_En_Bx,False,9504,2992,3.176,6512,2719
264,ovl_En_Changer,False,5584,3872,1.442,1712,3560
265,ovl_En_Clear_Tag,False,8464,36384,0.233,-27920,7733
266,ovl_En_Cow,False,4160,5184,0.802,-1024,3711
267,ovl_En_Crow,False,2256,5744,0.393,-3488,2020
268,ovl_En_Cs,False,7872,4736,1.662,3136,4463
269,ovl_En_Daiku,False,7904,6128,1.29,1776,5688
270,ovl_En_Daiku_Kakariko,False,7920,5296,1.495,2624,4852
271,ovl_En_Dekubaba,False,3328,15760,0.211,-12432,3041
272,ovl_En_Dekunuts,False,4080,6112,0.668,-2032,3706
273,ovl_En_Dh,False,3152,6976,0.452,-3824,2864
274,ovl_En_Dha,False,17952,4080,4.4,13872,3695
275,ovl_En_Diving_Game,False,5392,6880,0.784,-1488,4897
276,ovl_En_Dns,False,14640,5520,2.652,9120,5021
277,ovl_En_Dnt_Demo,False,784,4608,0.17,-3824,709
278,ovl_En_Dnt_Jiji,False,6192,6112,1.013,80,5532
279,ovl_En_Dnt_Nomal,False,2368,12544,0.189,-10176,2139
280,ovl_En_Dodojr,False,9232,7824,1.18,1408,7083
281,ovl_En_Dodongo,False,5008,11648,0.43,-6640,4584
282,ovl_En_Dog,False,1520,4608,0.33,-3088,1350
283,ovl_En_Door,False,5456,3680,1.483,1776,3294
284,ovl_En_Ds,False,3232,3072,1.052,160,2744
285,ovl_En_Du,False,2480,6848,0.362,-4368,2229
286,ovl_En_Dy_Extra,False,2288,1696,1.349,592,1541
287,ovl_En_Eg,False,1488,528,2.818,960,473
288,ovl_En_Eiyer,False,8208,7312,1.123,896,6640
289,ovl_En_Elf,False,5904,19184,0.308,-13280,5430
290,ovl_En_Encount1,False,1968,4720,0.417,-2752,1798
291,ovl_En_Encount2,False,6576,5392,1.22,1184,4990
292,ovl_En_Ex_Item,False,5344,5488,0.974,-144,4803
293,ovl_En_Ex_Ruppy,False,10128,4784,2.117,5344,4421
294,ovl_En_Fd,False,1392,11760,0.118,-10368,1239
295,ovl_En_Fd_Fire,False,7616,3504,2.174,4112,3112
296,ovl_En_Fhg_Fire,False,960,10688,0.09,-9728,859
297,ovl_En_Fire_Rock,False,2592,5200,0.498,-2608,2368
298,ovl_En_Firefly,False,1488,8720,0.171,-7232,1331
299,ovl_En_Fish,False,5376,8848,0.608,-3472,4806
300,ovl_En_Floormas,False,1744,13456,0.13,-11712,1574
301,ovl_En_Fr,False,9152,11888,0.77,-2736,8411
302,ovl_En_Fu,False,4288,3456,1.241,832,3136
303,ovl_En_Fw,False,3216,6176,0.521,-2960,2910
304,ovl_En_Fz,False,5952,8448,0.705,-2496,5393
305,ovl_En_G_Switch,False,2624,7840,0.335,-5216,2393
306,ovl_En_Ganon_Mant,False,1376,17056,0.081,-15680,1255
307,ovl_En_Ganon_Organ,False,352,29056,0.012,-28704,312
308,ovl_En_Gb,False,8240,6128,1.345,2112,5649
309,ovl_En_Ge1,False,416,8800,0.047,-8384,357
310,ovl_En_Ge2,False,5696,6736,0.846,-1040,5204
311,ovl_En_Ge3,False,35696,3312,10.778,32384,3017
312,ovl_En_GeldB,False,6400,21568,0.297,-15168,5837
313,ovl_En_GirlA,False,3376,12176,0.277,-8800,3008
314,ovl_En_Gm,False,1776,3728,0.476,-1952,1630
315,ovl_En_Go,False,2976,18368,0.162,-15392,2648
316,ovl_En_Go2,False,912,24976,0.037,-24064,820
317,ovl_En_Goma,False,12624,11744,1.075,880,10462
318,ovl_En_Goroiwa,False,2544,9856,0.258,-7312,2321
319,ovl_En_Gs,False,8336,7936,1.05,400,7282
320,ovl_En_Guest,False,4704,2864,1.642,1840,2647
321,ovl_En_Hata,False,528,1408,0.375,-880,469
322,ovl_En_Heishi1,False,8816,7120,1.238,1696,6569
323,ovl_En_Heishi2,False,1680,10144,0.166,-8464,1537
324,ovl_En_Heishi3,False,1280,2704,0.473,-1424,1142
325,ovl_En_Heishi4,False,3104,4400,0.705,-1296,2814
326,ovl_En_Hintnuts,False,3728,6672,0.559,-2944,3389
327,ovl_En_Holl,False,5440,4128,1.318,1312,3760
328,ovl_En_Honotrap,False,2416,5824,0.415,-3408,2209
329,ovl_En_Horse,False,15264,49760,0.307,-34496,13951
330,ovl_En_Horse_Game_Check,False,37200,4368,8.516,32832,3931
331,ovl_En_Horse_Ganon,False,784,3440,0.228,-2656,703
332,ovl_En_Horse_Link_Child,False,5168,7808,0.662,-2640,4698
333,ovl_En_Horse_Normal,False,2592,9856,0.263,-7264,2327
334,ovl_En_Horse_Zelda,False,17984,2768,6.497,15216,2532
335,ovl_En_Hs,False,3392,3072,1.104,320,2803
336,ovl_En_Hs2,False,2528,1552,1.629,976,1403
337,ovl_En_Hy,False,4576,14912,0.307,-10336,4211
338,ovl_En_Ice_Hono,False,1360,4896,0.278,-3536,1224
339,ovl_En_Ik,False,2112,19600,0.108,-17488,1880
340,ovl_En_In,False,2864,11888,0.241,-9024,2571
341,ovl_En_Insect,False,912,9792,0.093,-8880,823
342,ovl_En_Ishi,False,1472,37408,0.039,-35936,1276
343,ovl_En_It,False,4080,384,10.625,3696,323
344,ovl_En_Jj,False,28672,5648,5.076,23024,5476
345,ovl_En_Js,False,3504,2448,1.431,1056,2254
346,ovl_En_Jsjutan,False,1424,20080,0.071,-18656,1285
347,ovl_En_Kakasi,False,5664,3744,1.513,1920,3437
348,ovl_En_Kakasi2,False,16704,3344,4.995,13360,3061
349,ovl_En_Kakasi3,False,5536,4736,1.169,800,4339
350,ovl_En_Kanban,False,3824,13232,0.289,-9408,3455
351,ovl_En_Karebaba,False,1376,6752,0.204,-5376,1260
352,ovl_En_Ko,False,3440,16880,0.204,-13440,3139
353,ovl_En_Kusa,False,4464,5552,0.804,-1088,4076
354,ovl_En_Kz,False,3504,5616,0.624,-2112,3195
355,ovl_En_Light,False,2512,3728,0.674,-1216,2306
356,ovl_En_Lightbox,False,19904,1136,17.521,18768,1023
357,ovl_En_M_Fire1,False,4656,416,11.192,4240,358
358,ovl_En_M_Thunder,False,9840,5808,1.694,4032,5318
359,ovl_En_Ma1,False,14656,4880,3.003,9776,4469
360,ovl_En_Ma2,False,16928,4352,3.89,12576,3967
361,ovl_En_Ma3,False,960,4192,0.229,-3232,872
362,ovl_En_Mag,False,11104,9552,1.162,1552,8678
363,ovl_En_Mb,False,1520,16896,0.09,-15376,1370
364,ovl_En_Md,False,1136,9904,0.115,-8768,1017
365,ovl_En_Mk,False,22016,3696,5.957,18320,3395
366,ovl_En_Mm,False,14816,5856,2.53,8960,5368
367,ovl_En_Mm2,False,2784,3792,0.734,-1008,2532
368,ovl_En_Ms,False,1136,1792,0.634,-656,1023
369,ovl_En_Mu,False,3840,2416,1.589,1424,2168
370,ovl_En_Nb,False,32336,18928,1.708,13408,16783
371,ovl_En_Niw,False,70400,14336,4.911,56064,13355
372,ovl_En_Niw_Girl,False,3392,3264,1.039,128,3022
373,ovl_En_Niw_Lady,False,2240,7696,0.291,-5456,2083
374,ovl_En_Nutsball,False,1168,1680,0.695,-512,1033
375,ovl_En_Nwc,False,3888,2768,1.405,1120,2576
376,ovl_En_Ny,False,16688,6896,2.42,9792,6238
377,ovl_En_OE2,False,240,192,1.25,48,150
378,ovl_En_Okarina_Effect,False,14432,1472,9.804,12960,1332
379,ovl_En_Okarina_Tag,False,1728,6464,0.267,-4736,1572
380,ovl_En_Okuta,False,1408,9792,0.144,-8384,1274
381,ovl_En_Ossan,False,1696,29312,0.058,-27616,1522
382,ovl_En_Owl,False,6560,16048,0.409,-9488,5922
383,ovl_En_Part,False,592,5840,0.101,-5248,529
384,ovl_En_Peehat,False,9712,14352,0.677,-4640,8841
385,ovl_En_Po_Desert,False,16560,3664,4.52,12896,3339
386,ovl_En_Po_Field,False,3408,15280,0.223,-11872,3194
387,ovl_En_Po_Relay,False,2096,6224,0.337,-4128,1899
388,ovl_En_Po_Sisters,False,1648,19904,0.083,-18256,1521
389,ovl_En_Poh,False,1056,17264,0.061,-16208,960
390,ovl_En_Pu_box,False,2352,832,2.827,1520,738
391,ovl_En_Rd,False,912,10448,0.087,-9536,819
392,ovl_En_Reeba,False,1456,7264,0.2,-5808,1328
393,ovl_En_River_Sound,False,1264,2432,0.52,-1168,1105
394,ovl_En_Rl,False,1152,4496,0.256,-3344,1021
395,ovl_En_Rr,False,1376,10192,0.135,-8816,1257
396,ovl_En_Ru1,False,1200,31040,0.039,-29840,1022
397,ovl_En_Ru2,False,608,12304,0.049,-11696,518
398,ovl_En_Sa,False,656,8848,0.074,-8192,562
399,ovl_En_Sb,False,1744,5248,0.332,-3504,1583
400,ovl_En_Scene_Change,False,1424,432,3.296,992,368
401,ovl_En_Sda,False,1600,6208,0.258,-4608,1454
402,ovl_En_Shopnuts,False,928,3952,0.235,-3024,819
403,ovl_En_Si,False,1744,1264,1.38,480,1153
404,ovl_En_Siofuki,False,816,3616,0.226,-2800,751
405,ovl_En_Skb,False,1296,6416,0.202,-5120,1181
406,ovl_En_Skj,False,912,15344,0.059,-14432,809
407,ovl_En_Skjneedle,False,1360,960,1.417,400,852
408,ovl_En_Ssh,False,3968,9760,0.407,-5792,3446
409,ovl_En_St,False,1072,11440,0.094,-10368,936
410,ovl_En_Sth,False,432,16992,0.025,-16560,386
411,ovl_En_Stream,False,4240,1552,2.732,2688,1384
412,ovl_En_Sw,False,1088,14464,0.075,-13376,971
413,ovl_En_Syateki_Itm,False,2240,4544,0.493,-2304,2050
414,ovl_En_Syateki_Man,False,1792,4224,0.424,-2432,1636
415,ovl_En_Syateki_Niw,False,1856,8624,0.215,-6768,1704
416,ovl_En_Ta,False,960,15040,0.064,-14080,881
417,ovl_En_Takara_Man,False,1200,2512,0.478,-1312,1066
418,ovl_En_Tana,False,1248,1072,1.164,176,962
419,ovl_En_Tg,False,1424,1824,0.781,-400,1260
420,ovl_En_Tite,False,1152,11904,0.097,-10752,1020
421,ovl_En_Tk,False,320,8080,0.04,-7760,260
422,ovl_En_Torch,False,7072,240,29.467,6832,211
423,ovl_En_Torch2,False,6656,10160,0.655,-3504,6032
424,ovl_En_Toryo,False,800,3184,0.251,-2384,710
425,ovl_En_Tp,False,1680,7952,0.211,-6272,1524
426,ovl_En_Tr,False,2032,6512,0.312,-4480,1811
427,ovl_En_Trap,False,1040,4752,0.219,-3712,940
428,ovl_En_Tubo_Trap,False,1216,3520,0.345,-2304,1085
429,ovl_En_Vali,False,6704,10240,0.655,-3536,6003
430,ovl_En_Vase,False,1568,240,6.533,1328,204
431,ovl_En_Vb_Ball,False,416,4704,0.088,-4288,362
432,ovl_En_Viewer,False,3856,12864,0.3,-9008,3478
433,ovl_En_Vm,False,400,6544,0.061,-6144,351
434,ovl_En_Wall_Tubo,False,21424,1840,11.643,19584,1674
435,ovl_En_Wallmas,False,6000,6912,0.868,-912,5829
436,ovl_En_Weather_Tag,False,5968,4720,1.264,1248,4624
437,ovl_En_Weiyer,False,2768,6688,0.414,-3920,2484
438,ovl_En_Wf,False,4528,17328,0.261,-12800,4047
439,ovl_En_Wonder_Item,False,1280,4016,0.319,-2736,1152
440,ovl_En_Wonder_Talk,False,1216,3552,0.342,-2336,1093
441,ovl_En_Wonder_Talk2,False,2144,4256,0.504,-2112,1957
442,ovl_En_Wood02,False,1600,4704,0.34,-3104,1436
443,ovl_En_Xc,False,1728,27568,0.063,-25840,1498
444,ovl_En_Yabusame_Mark,False,3360,3072,1.094,288,2836
445,ovl_En_Yukabyun,False,5392,1680,3.21,3712,1535
446,ovl_En_Zf,False,11840,27360,0.433,-15520,10785
447,ovl_En_Zl1,False,2464,15952,0.154,-13488,2266
448,ovl_En_Zl2,False,544,18976,0.029,-18432,480
449,ovl_En_Zl3,False,1504,33792,0.045,-32288,1320
450,ovl_En_Zl4,False,4832,19056,0.254,-14224,4470
451,ovl_En_Zo,False,1696,10144,0.167,-8448,1479
452,ovl_En_fHG,False,1760,11616,0.152,-9856,1626
453,ovl_End_Title,False,2000,17024,0.117,-15024,1803
454,ovl_Fishing,False,1744,83664,0.021,-81920,1548
455,ovl_Item_B_Heart,False,2336,1184,1.973,1152,1074
456,ovl_Item_Etcetera,False,24608,2544,9.673,22064,2301
457,ovl_Item_Inbox,False,17168,336,51.095,16832,302
458,ovl_Item_Ocarina,False,6384,2032,3.142,4352,1839
459,ovl_Item_Shield,False,15536,2736,5.678,12800,2468
460,ovl_Magic_Dark,False,2080,6560,0.317,-4480,1917
461,ovl_Magic_Fire,False,1344,9104,0.148,-7760,1217
462,ovl_Magic_Wind,False,1984,8016,0.248,-6032,1781
463,ovl_Mir_Ray,False,2144,6704,0.32,-4560,1940
464,ovl_Obj_Bean,False,368,10720,0.034,-10352,320
465,ovl_Obj_Blockstop,False,4336,400,10.84,3936,341
466,ovl_Obj_Bombiwa,False,6000,1392,4.31,4608,1248
467,ovl_Obj_Comb,False,5936,2240,2.65,3696,2063
468,ovl_Obj_Dekujr,False,7840,1760,4.455,6080,1562
469,ovl_Obj_Elevator,False,5328,1168,4.562,4160,1086
470,ovl_Obj_Hamishi,False,2048,2256,0.908,-208,1869
471,ovl_Obj_Hana,False,5056,768,6.583,4288,687
472,ovl_Obj_Hsblock,False,2432,1792,1.357,640,1631
473,ovl_Obj_Ice_Poly,False,1264,2624,0.482,-1360,1133
474,ovl_Obj_Kibako,False,3520,3376,1.043,144,3021
475,ovl_Obj_Kibako2,False,5792,1792,3.232,4000,1619
476,ovl_Obj_Lift,False,5488,2768,1.983,2720,2514
477,ovl_Obj_Lightswitch,False,1840,5840,0.315,-4000,1641
478,ovl_Obj_Makekinsuta,False,416,672,0.619,-256,347
479,ovl_Obj_Makeoshihiki,False,1360,1424,0.955,-64,1195
480,ovl_Obj_Mure,False,4304,5280,0.815,-976,3890
481,ovl_Obj_Mure2,False,5216,2704,1.929,2512,2484
482,ovl_Obj_Mure3,False,2096,1968,1.065,128,1749
483,ovl_Obj_Oshihiki,False,1136,7760,0.146,-6624,1003
484,ovl_Obj_Roomtimer,False,1824,576,3.167,1248,513
485,ovl_Obj_Switch,False,4320,8352,0.517,-4032,3899
486,ovl_Obj_Syokudai,False,4064,3296,1.233,768,2957
487,ovl_Obj_Timeblock,False,432,3520,0.123,-3088,373
488,ovl_Obj_Tsubo,False,336,4240,0.079,-3904,282
489,ovl_Obj_Warp2block,False,9648,3248,2.97,6400,2925
490,ovl_Object_Kankyo,False,1216,13776,0.088,-12560,1102
491,ovl_Oceff_Spot,False,336,4208,0.08,-3872,298
492,ovl_Oceff_Storm,False,2896,7344,0.394,-4448,2711
493,ovl_Oceff_Wipe,False,3136,3616,0.867,-480,2905
494,ovl_Oceff_Wipe2,False,2128,6208,0.343,-4080,2011
495,ovl_Oceff_Wipe3,False,18992,6176,3.075,12816,5999
496,ovl_Oceff_Wipe4,False,3520,4272,0.824,-752,3159
497,ovl_Shot_Sun,False,624,1856,0.336,-1232,537
498,gameplay_keep,False,2864,354224,0.008,-351360,2827
499,gameplay_field_keep,False,354224,54064,6.552,300160,51718
500,gameplay_dangeon_keep,False,54064,97008,0.557,-42944,52283
501,gameplay_object_exchange_static,False,97008,16,6063.0,96992,0
502,object_link_boy,False,16,227328,0.0,-227312,16
503,object_link_child,False,227328,184192,1.234,43136,161159
504,object_box,False,184192,24576,7.495,159616,24127
505,object_human,False,24576,78208,0.314,-53632,24135
506,object_okuta,False,78208,15488,5.05,62720,15189
507,object_poh,False,15488,20704,0.748,-5216,13933
508,object_wallmaster,False,20704,41072,0.504,-20368,19706
509,object_dy_obj,False,41072,120112,0.342,-79040,39813
510,object_firefly,False,120112,6336,18.957,113776,6081
511,object_dodongo,False,6336,39232,0.162,-32896,6102
512,object_fire,False,39232,16544,2.371,22688,15678
513,object_niw,False,16544,9536,1.735,7008,8381
514,object_tite,False,9536,14896,0.64,-5360,8972
515,object_reeba,False,14896,7920,1.881,6976,7482
516,object_peehat,False,7920,7312,1.083,608,6796
517,object_kingdodongo,False,7312,199904,0.037,-192592,7016
518,object_horse,False,199904,57104,3.501,142800,55691
519,object_zf,False,57104,91040,0.627,-33936,54348
520,object_goma,False,91040,128512,0.708,-37472,86843
521,object_zl1,False,128512,82880,1.551,45632,78878
522,object_gol,False,82880,16928,4.896,65952,15900
523,object_bubble,False,16928,4288,3.948,12640,4022
524,object_dodojr,False,4288,8432,0.509,-4144,3985
525,object_torch2,False,8432,18288,0.461,-9856,7484
526,object_bl,False,18288,22608,0.809,-4320,15139
527,object_tp,False,22608,7408,3.052,15200,6372
528,object_oA1,False,7408,18192,0.407,-10784,6681
529,object_st,False,18192,23472,0.775,-5280,16812
530,object_bw,False,23472,8800,2.667,14672,7898
531,object_ei,False,8800,13344,0.659,-4544,8345
532,object_horse_normal,False,13344,40896,0.326,-27552,12887
533,object_oB1,False,40896,26288,1.556,14608,25551
534,object_o_anime,False,26288,8528,3.083,17760,7831
535,object_spot04_objects,False,8528,5824,1.464,2704,5644
536,object_ddan_objects,False,5824,34656,0.168,-28832,5708
537,object_hidan_objects,False,34656,97568,0.355,-62912,34026
538,object_horse_ganon,False,97568,49296,1.979,48272,46770
539,object_oA2,False,49296,22224,2.218,27072,20199
540,object_spot00_objects,False,22224,7184,3.094,15040,6614
541,object_mb,False,7184,82336,0.087,-75152,7011
542,object_bombf,False,82336,6656,12.37,75680,6493
543,object_sk2,False,6656,59392,0.112,-52736,6281
544,object_oE1,False,59392,26640,2.229,32752,25013
545,object_oE_anime,False,26640,20576,1.295,6064,19768
546,object_oE2,False,20576,23152,0.889,-2576,19749
547,object_ydan_objects,False,23152,36992,0.626,-13840,22613
548,object_gnd,False,36992,77824,0.475,-40832,35134
549,object_am,False,77824,23376,3.329,54448,22813
550,object_dekubaba,False,23376,14784,1.581,8592,13828
551,object_oA3,False,14784,8496,1.74,6288,7906
552,object_oA4,False,8496,5936,1.431,2560,5036
553,object_oA5,False,5936,5808,1.022,128,4346
554,object_oA6,False,5808,6656,0.873,-848,4396
555,object_oA7,False,6656,5456,1.22,1200,4069
556,object_jj,False,5456,47808,0.114,-42352,4824
557,object_oA8,False,47808,6064,7.884,41744,5341
558,object_oA9,False,6064,1312,4.622,4752,1167
559,object_oB2,False,1312,16608,0.079,-15296,1179
560,object_oB3,False,16608,17552,0.946,-944,13343
561,object_oB4,False,17552,6256,2.806,11296,4913
562,object_horse_zelda,False,6256,29024,0.216,-22768,5922
563,object_opening_demo1,False,29024,20576,1.411,8448,20086
564,object_warp1,False,20576,11440,1.799,9136,11215
565,object_b_heart,False,11440,1600,7.15,9840,1260
566,object_dekunuts,False,1600,13920,0.115,-12320,1352
567,object_oE3,False,13920,28960,0.481,-15040,12588
568,object_oE4,False,28960,20432,1.417,8528,15782
569,object_menkuri_objects,False,20432,35600,0.574,-15168,19323
570,object_oE5,False,35600,21952,1.622,13648,21406
571,object_oE6,False,21952,11856,1.852,10096,11445
572,object_oE7,False,11856,10848,1.093,1008,10096
573,object_oE8,False,10848,13264,0.818,-2416,10126
574,object_oE9,False,13264,12048,1.101,1216,10532
575,object_oE10,False,12048,10704,1.126,1344,9546
576,object_oE11,False,10704,12784,0.837,-2080,9722
577,object_oE12,False,12784,14272,0.896,-1488,11446
578,object_vali,False,14272,18512,0.771,-4240,13876
579,object_oA10,False,18512,11952,1.549,6560,10884
580,object_oA11,False,11952,5568,2.147,6384,4198
581,object_mizu_objects,False,5568,45856,0.121,-40288,4878
582,object_fhg,False,45856,74208,0.618,-28352,43108
583,object_ossan,False,74208,39760,1.866,34448,35470
584,object_mori_hineri1,False,39760,21744,1.829,18016,17654
585,object_Bb,False,21744,6720,3.236,15024,5878
586,object_toki_objects,False,6720,33872,0.198,-27152,6312
587,object_yukabyun,False,33872,5360,6.319,28512,5094
588,object_zl2,False,5360,68992,0.078,-63632,5328
589,object_mjin,False,68992,4752,14.519,64240,4545
590,object_mjin_flash,False,4752,4096,1.16,656,3957
591,object_mjin_dark,False,4096,4096,1.0,0,2923
592,object_mjin_flame,False,4096,4096,1.0,0,2971
593,object_mjin_ice,False,4096,4096,1.0,0,2947
594,object_mjin_soul,False,4096,4096,1.0,0,2954
595,object_mjin_wind,False,4096,4096,1.0,0,2933
596,object_mjin_oka,False,4096,7008,0.584,-2912,4041
597,object_haka_objects,False,7008,120496,0.058,-113488,6762
598,object_spot06_objects,False,120496,11680,10.316,108816,10826
599,object_ice_objects,False,11680,36176,0.323,-24496,10943
600,object_relay_objects,False,36176,13872,2.608,22304,12818
601,object_mori_hineri1a,False,13872,13504,1.027,368,12231
602,object_mori_hineri2,False,13504,17408,0.776,-3904,10076
603,object_mori_hineri2a,False,17408,24752,0.703,-7344,12709
604,object_mori_objects,False,24752,35344,0.7,-10592,20214
605,object_mori_tex,False,35344,40448,0.874,-5104,34488
606,object_spot08_obj,False,40448,22016,1.837,18432,21924
607,object_warp2,False,22016,16,1376.0,22000,16
608,object_hata,False,16,12256,0.001,-12240,3
609,object_bird,False,12256,8608,1.424,3648,8422
610,object_wood02,False,8608,34768,0.248,-26160,8217
611,object_lightbox,False,34768,8000,4.346,26768,7395
612,object_pu_box,False,8000,5632,1.42,2368,4759
613,object_trap,False,5632,9184,0.613,-3552,5458
614,object_vase,False,9184,5520,1.664,3664,5477
615,object_im,False,5520,74288,0.074,-68768,5446
616,object_ta,False,74288,58352,1.273,15936,51565
617,object_tk,False,58352,48720,1.198,9632,46191
618,object_xc,False,48720,114944,0.424,-66224,46744
619,object_vm,False,114944,16240,7.078,98704,15729
620,object_bv,False,16240,127408,0.127,-111168,15068
621,object_hakach_objects,False,127408,27376,4.654,100032,25749
622,object_efc_crystal_light,False,27376,2720,10.065,24656,2542
623,object_efc_fire_ball,False,2720,3328,0.817,-608,2696
624,object_efc_flash,False,3328,16,208.0,3312,7
625,object_efc_lgt_shower,False,16,4816,0.003,-4800,0
626,object_efc_star_field,False,4816,6096,0.79,-1280,4478
627,object_god_lgt,False,6096,17232,0.354,-11136,5728
628,object_light_ring,False,17232,4736,3.639,12496,4031
629,object_triforce_spot,False,4736,10512,0.451,-5776,4518
630,object_medal,False,10512,20800,0.505,-10288,9914
631,object_bdan_objects,False,20800,52496,0.396,-31696,19822
632,object_sd,False,52496,50912,1.031,1584,49066
633,object_rd,False,50912,61424,0.829,-10512,47304
634,object_po_sisters,False,61424,58304,1.054,3120,56214
635,object_heavy_object,False,58304,6880,8.474,51424,6591
636,object_gndd,False,6880,72192,0.095,-65312,6766
637,object_fd,False,72192,71280,1.013,912,66479
638,object_du,False,71280,73776,0.966,-2496,66502
639,object_fw,False,73776,32224,2.289,41552,31533
640,object_horse_link_child,False,32224,35616,0.905,-3392,30110
641,object_spot02_objects,False,35616,91680,0.388,-56064,32393
642,object_haka,False,91680,5216,17.577,86464,5208
643,object_ru1,False,5216,80512,0.065,-75296,5194
644,object_syokudai,False,80512,15504,5.193,65008,15304
645,object_fd2,False,15504,72336,0.214,-56832,14694
646,object_dh,False,72336,37056,1.952,35280,35672
647,object_rl,False,37056,31568,1.174,5488,30600
648,object_efc_tw,False,31568,4848,6.512,26720,4797
649,object_demo_tre_lgt,False,4848,16,303.0,4832,1
650,object_gi_key,False,16,2592,0.006,-2576,11
651,object_mir_ray,False,2592,7424,0.349,-4832,2269
652,object_brob,False,7424,6816,1.089,608,6431
653,object_gi_jewel,False,6816,13952,0.489,-7136,6080
654,object_spot09_obj,False,13952,100496,0.139,-86544,11509
655,object_spot18_obj,False,100496,51728,1.943,48768,49534
656,object_bdoor,False,51728,30144,1.716,21584,29482
657,object_spot17_obj,False,30144,6192,4.868,23952,5760
658,object_shop_dungen,False,6192,14880,0.416,-8688,5915
659,object_nb,False,14880,98784,0.151,-83904,14647
660,object_mo,False,98784,36976,2.672,61808,35975
661,object_sb,False,36976,11424,3.237,25552,10334
662,object_gi_melody,False,11424,3360,3.4,8064,2644
663,object_gi_heart,False,3360,496,6.774,2864,366
664,object_gi_compass,False,496,3344,0.148,-2848,410
665,object_gi_bosskey,False,3344,4112,0.813,-768,2449
666,object_gi_medal,False,4112,21360,0.193,-17248,2843
667,object_gi_nuts,False,21360,4544,4.701,16816,3648
668,object_sa,False,4544,86576,0.052,-82032,4454
669,object_gi_hearts,False,86576,6064,14.277,80512,5881
670,object_gi_arrowcase,False,6064,3248,1.867,2816,2352
671,object_gi_bombpouch,False,3248,3680,0.883,-432,2367
672,object_in,False,3680,101456,0.036,-97776,3537
673,object_tr,False,101456,77360,1.311,24096,71548
674,object_spot16_obj,False,77360,5376,14.39,71984,5280
675,object_oE1s,False,5376,25952,0.207,-20576,5230
676,object_oE4s,False,25952,19968,1.3,5984,18229
677,object_os_anime,False,19968,42560,0.469,-22592,18776
678,object_gi_bottle,False,42560,2288,18.601,40272,2052
679,object_gi_stick,False,2288,1728,1.324,560,1285
680,object_gi_map,False,1728,4448,0.388,-2720,1315
681,object_oF1d_map,False,4448,66976,0.066,-62528,4359
682,object_ru2,False,66976,63696,1.051,3280,59675
683,object_gi_shield_1,False,63696,3408,18.69,60288,3256
684,object_dekujr,False,3408,13584,0.251,-10176,3221
685,object_gi_magicpot,False,13584,4560,2.979,9024,4209
686,object_gi_bomb_1,False,4560,3248,1.404,1312,2496
687,object_oF1s,False,3248,34976,0.093,-31728,3204
688,object_ma2,False,34976,40688,0.86,-5712,31319
689,object_gi_purse,False,40688,7024,5.793,33664,6981
690,object_hni,False,7024,44912,0.156,-37888,6436
691,object_tw,False,44912,241584,0.186,-196672,43667
692,object_rr,False,241584,3584,67.406,238000,3428
693,object_bxa,False,3584,11248,0.319,-7664,2843
694,object_anubice,False,11248,14752,0.762,-3504,10259
695,object_gi_gerudo,False,14752,4928,2.994,9824,4644
696,object_gi_arrow,False,4928,6928,0.711,-2000,4119
697,object_gi_bomb_2,False,6928,1696,4.085,5232,1356
698,object_gi_egg,False,1696,4896,0.346,-3200,1278
699,object_gi_scale,False,4896,3568,1.372,1328,2697
700,object_gi_shield_2,False,3568,4208,0.848,-640,2627
701,object_gi_hookshot,False,4208,5472,0.769,-1264,3206
702,object_gi_ocarina,False,5472,2992,1.829,2480,2259
703,object_gi_milk,False,2992,5232,0.572,-2240,2603
704,object_ma1,False,5232,36224,0.144,-30992,5022
705,object_ganon,False,36224,70912,0.511,-34688,32943
706,object_sst,False,70912,109488,0.648,-38576,62391
707,object_ny,False,109488,8560,12.791,100928,7739
708,object_fr,False,8560,46256,0.185,-37696,8120
709,object_gi_pachinko,False,46256,3168,14.601,43088,3099
710,object_gi_boomerang,False,3168,3488,0.908,-320,2351
711,object_gi_bow,False,3488,3376,1.033,112,2404
712,object_gi_glasses,False,3376,4480,0.754,-1104,2551
713,object_gi_liquid,False,4480,6352,0.705,-1872,3530
714,object_ani,False,6352,30464,0.209,-24112,6193
715,object_demo_6k,False,30464,15264,1.996,15200,14854
716,object_gi_shield_3,False,15264,4800,3.18,10464,3808
717,object_gi_letter,False,4800,3584,1.339,1216,2713
718,object_spot15_obj,False,3584,7424,0.483,-3840,2793
719,object_jya_obj,False,7424,115008,0.065,-107584,6517
720,object_gi_clothes,False,115008,6240,18.431,108768,5727
721,object_gi_bean,False,6240,2240,2.786,4000,2192
722,object_gi_fish,False,2240,2384,0.94,-144,1657
723,object_gi_saw,False,2384,2944,0.81,-560,1790
724,object_gi_hammer,False,2944,3264,0.902,-320,2183
725,object_gi_grass,False,3264,3088,1.057,176,2241
726,object_gi_longsword,False,3088,2240,1.379,848,1704
727,object_spot01_objects,False,2240,9360,0.239,-7120,1821
728,object_md,False,9360,41296,0.227,-31936,9216
729,object_km1,False,41296,22976,1.797,18320,20097
730,object_kw1,False,22976,26848,0.856,-3872,19329
731,object_zo,False,26848,49216,0.546,-22368,25713
732,object_kz,False,49216,34528,1.425,14688,32795
733,object_umajump,False,34528,5232,6.599,29296,5190
734,object_masterkokiri,False,5232,1216,4.303,4016,1214
735,object_masterkokirihead,False,1216,11424,0.106,-10208,1205
736,object_mastergolon,False,11424,272,42.0,11152,270
737,object_masterzoora,False,272,1952,0.139,-1680,270
738,object_aob,False,1952,22192,0.088,-20240,1920
739,object_ik,False,22192,132560,0.167,-110368,21683
740,object_ahg,False,132560,22960,5.774,109600,22384
741,object_cne,False,22960,10704,2.145,12256,9318
742,object_gi_niwatori,False,10704,6640,1.612,4064,5592
743,object_skj,False,6640,36400,0.182,-29760,6225
744,object_gi_bottle_letter,False,36400,3200,11.375,33200,3085
745,object_bji,False,3200,16784,0.191,-13584,3136
746,object_bba,False,16784,17040,0.985,-256,14584
747,object_gi_ocarina_0,False,17040,3088,5.518,13952,2961
748,object_ds,False,3088,18304,0.169,-15216,2641
749,object_ane,False,18304,28592,0.64,-10288,17622
750,object_boj,False,28592,23744,1.204,4848,21744
751,object_spot03_object,False,23744,5728,4.145,18016,5412
752,object_spot07_object,False,5728,27952,0.205,-22224,5392
753,object_fz,False,27952,13520,2.067,14432,12150
754,object_bob,False,13520,20256,0.667,-6736,13180
755,object_ge1,False,20256,42160,0.48,-21904,18439
756,object_yabusame_point,False,42160,3664,11.507,38496,3490
757,object_gi_boots_2,False,3664,7104,0.516,-3440,3076
758,object_gi_seed,False,7104,2752,2.581,4352,2119
759,object_gnd_magic,False,2752,4736,0.581,-1984,2645
760,object_d_elevator,False,4736,5008,0.946,-272,4674
761,object_d_hsblock,False,5008,5984,0.837,-976,4765
762,object_d_lift,False,5984,6144,0.974,-160,5681
763,object_mamenoki,False,6144,9952,0.617,-3808,5857
764,object_goroiwa,False,9952,6304,1.579,3648,5954
765,object_toryo,False,6304,29024,0.217,-22720,6166
766,object_daiku,False,29024,34928,0.831,-5904,24536
767,object_nwc,False,34928,3488,10.014,31440,3367
768,object_blkobj,False,3488,80016,0.044,-76528,3204
769,object_gm,False,80016,720,111.133,79296,685
770,object_ms,False,720,15824,0.046,-15104,716
771,object_hs,False,15824,25200,0.628,-9376,13650
772,object_ingate,False,25200,4592,5.488,20608,4531
773,object_lightswitch,False,4592,9248,0.497,-4656,4582
774,object_kusa,False,9248,896,10.321,8352,700
775,object_tsubo,False,896,6640,0.135,-5744,893
776,object_gi_gloves,False,6640,6496,1.022,144,6115
777,object_gi_coin,False,6496,2128,3.053,4368,1738
778,object_kanban,False,2128,6064,0.351,-3936,1554
779,object_gjyo_objects,False,6064,5616,1.08,448,4945
780,object_owl,False,5616,65728,0.085,-60112,5572
781,object_mk,False,65728,24064,2.731,41664,21296
782,object_fu,False,24064,27808,0.865,-3744,19987
783,object_gi_ki_tan_mask,False,27808,3568,7.794,24240,3451
784,object_gi_redead_mask,False,3568,2704,1.32,864,2029
785,object_gi_skj_mask,False,2704,3296,0.82,-592,2019
786,object_gi_rabit_mask,False,3296,3840,0.858,-544,2456
787,object_gi_truth_mask,False,3840,6240,0.615,-2400,3087
788,object_ganon_objects,False,6240,4464,1.398,1776,4367
789,object_siofuki,False,4464,3504,1.274,960,3490
790,object_stream,False,3504,2688,1.304,816,517
791,object_mm,False,2688,32880,0.082,-30192,2671
792,object_fa,False,32880,15248,2.156,17632,13440
793,object_os,False,15248,18032,0.846,-2784,13765
794,object_gi_eye_lotion,False,18032,2416,7.464,15616,2140
795,object_gi_powder,False,2416,2944,0.821,-528,1846
796,object_gi_mushroom,False,2944,3280,0.898,-336,2151
797,object_gi_ticketstone,False,3280,4768,0.688,-1488,2682
798,object_gi_brokensword,False,4768,2448,1.948,2320,1987
799,object_js,False,2448,24368,0.1,-21920,2210
800,object_cs,False,24368,34128,0.714,-9760,23525
801,object_gi_prescription,False,34128,3104,10.995,31024,2932
802,object_gi_bracelet,False,3104,3056,1.016,48,2348
803,object_gi_soldout,False,3056,1232,2.481,1824,1054
804,object_gi_frog,False,1232,4368,0.282,-3136,1178
805,object_mag,False,4368,153920,0.028,-149552,3579
806,object_door_gerudo,False,128064,2464,51.974,125600,2384
807,object_gt,False,2464,79344,0.031,-76880,2366
808,object_efc_erupc,False,79344,10480,7.571,68864,8891
809,object_zl2_anime1,False,10480,46608,0.225,-36128,9720
810,object_zl2_anime2,False,46608,43744,1.065,2864,42413
811,object_gi_golonmask,False,43744,6064,7.214,37680,5888
812,object_gi_zoramask,False,6064,5680,1.068,384,4905
813,object_gi_gerudomask,False,5680,5120,1.109,560,4364
814,object_ganon2,False,5120,220144,0.023,-215024,5005
815,object_ka,False,220144,26560,8.289,193584,25846
816,object_ts,False,26560,20464,1.298,6096,19911
817,object_zg,False,20464,4608,4.441,15856,4575
818,object_gi_hoverboots,False,4608,7792,0.591,-3184,4507
819,object_gi_m_arrow,False,7792,3712,2.099,4080,2972
820,object_ds2,False,3712,17008,0.218,-13296,3126
821,object_ec,False,17008,51504,0.33,-34496,16460
822,object_fish,False,51504,87536,0.588,-36032,50198
823,object_gi_sutaru,False,87536,1616,54.168,85920,1309
824,object_gi_goddess,False,1616,3152,0.513,-1536,1246
825,object_ssh,False,3152,23552,0.134,-20400,2956
826,object_bigokuta,False,23552,27600,0.853,-4048,19849
827,object_bg,False,27600,29376,0.94,-1776,25893
828,object_spot05_objects,False,29376,4848,6.059,24528,4749
829,object_spot12_obj,False,4848,9152,0.53,-4304,4766
830,object_bombiwa,False,9152,2816,3.25,6336,2808
831,object_hintnuts,False,2816,12608,0.223,-9792,2650
832,object_rs,False,12608,18560,0.679,-5952,11496
833,object_spot00_break,False,18560,7712,2.407,10848,7360
834,object_gla,False,7712,40688,0.19,-32976,7466
835,object_shopnuts,False,40688,17808,2.285,22880,16271
836,object_geldb,False,17808,46832,0.38,-29024,16668
837,object_gr,False,46832,40080,1.168,6752,38602
838,object_dog,False,40080,29344,1.366,10736,28877
839,object_jya_iron,False,29344,9824,2.987,19520,9540
840,object_jya_door,False,9824,8832,1.112,992,8488
841,object_spot01_objects2,False,8832,16,552.0,8816,9
842,object_spot11_obj,False,16,6800,0.002,-6784,16
843,object_kibako2,False,6800,4288,1.586,2512,4188
844,object_dns,False,4288,14288,0.3,-10000,4020
845,object_dnk,False,14288,11824,1.208,2464,10731
846,object_gi_fire,False,11824,4064,2.909,7760,3660
847,object_gi_insect,False,4064,3056,1.33,1008,2500
848,object_gi_butterfly,False,3056,3024,1.011,32,1907
849,object_gi_ghost,False,3024,3504,0.863,-480,2437
850,object_gi_soul,False,3504,4016,0.873,-512,2730
851,object_bowl,False,4016,13552,0.296,-9536,3289
852,object_po_field,False,13552,27200,0.498,-13648,12826
853,object_demo_kekkai,False,27200,60688,0.448,-33488,25765
854,object_efc_doughnut,False,60688,4176,14.533,56512,3882
855,object_gi_dekupouch,False,4176,4176,1.0,0,3543
856,object_ganon_anime1,False,4176,48192,0.087,-44016,4021
857,object_ganon_anime2,False,48192,66864,0.721,-18672,47739
858,object_ganon_anime3,False,66864,83952,0.796,-17088,66136
859,object_gi_rupy,False,83952,2048,40.992,81904,1989
860,object_spot01_matoya,False,2048,15504,0.132,-13456,1976
861,object_spot01_matoyab,False,15504,8672,1.788,6832,7983
862,object_po_composer,False,8672,28576,0.303,-19904,8201
863,object_mu,False,28576,44624,0.64,-16048,26000
864,object_wf,False,44624,42240,1.056,2384,37447
865,object_skb,False,42240,18448,2.29,23792,17234
866,object_gj,False,18448,42784,0.431,-24336,17023
867,object_geff,False,42784,4016,10.653,38768,3822
868,object_haka_door,False,4016,14704,0.273,-10688,3969
869,object_gs,False,14704,2688,5.47,12016,2681
870,object_ps,False,2688,51456,0.052,-48768,2594
871,object_bwall,False,51456,4432,11.61,47024,4321
872,object_crow,False,4432,4304,1.03,128,4145
873,object_cow,False,4304,20144,0.214,-15840,3977
874,object_cob,False,20144,8720,2.31,11424,7247
875,object_gi_sword_1,False,8720,3360,2.595,5360,2903
876,object_door_killer,False,3360,7136,0.471,-3776,2494
877,object_ouke_haka,False,7136,2416,2.954,4720,2280
878,object_timeblock,False,2416,2912,0.83,-496,2393
879,object_zl4,False,2912,118304,0.025,-115392,2894
880,g_pn_01,False,118304,10368,11.41,107936,10066
881,g_pn_02,False,10368,10368,1.0,0,6004
882,g_pn_03,False,10368,10368,1.0,0,6380
883,g_pn_04,False,10368,10368,1.0,0,5553
884,g_pn_05,False,10368,10368,1.0,0,5628
885,g_pn_06,False,10368,10368,1.0,0,6336
886,g_pn_07,False,10368,10368,1.0,0,6443
887,g_pn_08,False,10368,10368,1.0,0,6671
888,g_pn_09,False,10368,10368,1.0,0,6402
889,g_pn_10,False,10368,10368,1.0,0,5714
890,g_pn_11,False,10368,10368,1.0,0,6206
891,g_pn_12,False,10368,10368,1.0,0,6110
892,g_pn_13,False,10368,10368,1.0,0,5937
893,g_pn_14,False,10368,10368,1.0,0,6530
894,g_pn_15,False,10368,10368,1.0,0,6595
895,g_pn_16,False,10368,10368,1.0,0,6649
896,g_pn_17,False,10368,10368,1.0,0,6545
897,g_pn_18,False,10368,10368,1.0,0,5484
898,g_pn_19,False,10368,10368,1.0,0,5235
899,g_pn_20,False,10368,10368,1.0,0,5569
900,g_pn_21,False,10368,10368,1.0,0,5792
901,g_pn_22,False,10368,10368,1.0,0,6402
902,g_pn_23,False,10368,10368,1.0,0,6489
903,g_pn_24,False,10368,10368,1.0,0,4859
904,g_pn_25,False,10368,10368,1.0,0,6697
905,g_pn_26,False,10368,10368,1.0,0,6432
906,g_pn_27,False,10368,10368,1.0,0,6734
907,g_pn_28,False,10368,10368,1.0,0,6585
908,g_pn_29,False,10368,10368,1.0,0,5690
909,g_pn_30,False,10368,10368,1.0,0,4345
910,g_pn_31,False,10368,10368,1.0,0,4764
911,g_pn_32,False,10368,10368,1.0,0,5062
912,g_pn_33,False,10368,10368,1.0,0,5558
913,g_pn_34,False,10368,10368,1.0,0,5093
914,g_pn_35,False,10368,10368,1.0,0,5626
915,g_pn_36,False,10368,10368,1.0,0,5778
916,g_pn_37,False,10368,10368,1.0,0,6090
917,g_pn_38,False,10368,10368,1.0,0,6726
918,g_pn_39,False,10368,10368,1.0,0,6451
919,g_pn_40,False,10368,10368,1.0,0,5670
920,g_pn_41,False,10368,10368,1.0,0,5786
921,g_pn_42,False,10368,10368,1.0,0,5727
922,g_pn_43,False,10368,10368,1.0,0,5963
923,g_pn_44,False,10368,10368,1.0,0,6503
924,g_pn_45,False,10368,10368,1.0,0,6081
925,g_pn_46,False,10368,10368,1.0,0,6046
926,g_pn_47,False,10368,10368,1.0,0,6860
927,g_pn_48,False,10368,10368,1.0,0,7012
928,g_pn_49,False,10368,10368,1.0,0,6776
929,g_pn_50,False,10368,10368,1.0,0,6272
930,g_pn_51,False,10368,10368,1.0,0,5940
931,g_pn_52,False,10368,10368,1.0,0,6087
932,g_pn_53,False,10368,10368,1.0,0,6295
933,g_pn_54,False,10368,10368,1.0,0,6435
934,g_pn_55,False,10368,10368,1.0,0,6552
935,g_pn_56,False,10368,10368,1.0,0,6413
936,g_pn_57,False,10368,10368,1.0,0,6801
937,z_select_static,False,10368,8704,1.191,1664,4233
938,nintendo_rogo_static,False,8704,11712,0.743,-3008,6607
939,title_static,False,11712,291904,0.04,-280192,11115
940,parameter_static,False,316096,15104,20.928,300992,10632
941,vr_fine0_static,False,15104,49152,0.307,-34048,15102
942,vr_fine0_pal_static,False,49152,256,192.0,48896,251
943,vr_fine1_static,False,256,49152,0.005,-48896,256
944,vr_fine1_pal_static,False,49152,256,192.0,48896,256
945,vr_fine2_static,False,256,49152,0.005,-48896,256
946,vr_fine2_pal_static,False,49152,256,192.0,48896,254
947,vr_fine3_static,False,256,49152,0.005,-48896,256
948,vr_fine3_pal_static,False,49152,256,192.0,48896,252
949,vr_cloud0_static,False,256,49152,0.005,-48896,256
950,vr_cloud0_pal_static,False,49152,256,192.0,48896,256
951,vr_cloud1_static,False,256,49152,0.005,-48896,256
952,vr_cloud1_pal_static,False,49152,256,192.0,48896,255
953,vr_cloud2_static,False,256,49152,0.005,-48896,255
954,vr_cloud2_pal_static,False,49152,256,192.0,48896,254
955,vr_cloud3_static,False,256,49152,0.005,-48896,253
956,vr_cloud3_pal_static,False,49152,256,192.0,48896,253
957,vr_holy0_static,False,256,65536,0.004,-65280,252
958,vr_holy0_pal_static,False,65536,256,256.0,65280,251
959,vr_holy1_static,False,256,65536,0.004,-65280,255
960,vr_holy1_pal_static,False,65536,256,256.0,65280,255
961,vr_MDVR_static,False,256,262144,0.001,-261888,255
962,vr_MDVR_pal_static,False,262144,2048,128.0,260096,2044
963,vr_MNVR_static,False,2048,262144,0.008,-260096,2038
964,vr_MNVR_pal_static,False,262144,2048,128.0,260096,2037
965,vr_RUVR_static,False,2048,262144,0.008,-260096,2045
966,vr_RUVR_pal_static,False,262144,2048,128.0,260096,2041
967,vr_LHVR_static,False,2048,262144,0.008,-260096,2039
968,vr_LHVR_pal_static,False,262144,2048,128.0,260096,2038
969,vr_KHVR_static,False,2048,262144,0.008,-260096,2043
970,vr_KHVR_pal_static,False,262144,2048,128.0,260096,2042
971,vr_K3VR_static,False,2048,196608,0.01,-194560,2047
972,vr_K3VR_pal_static,False,196608,1536,128.0,195072,1527
973,vr_K4VR_static,False,1536,196608,0.008,-195072,1529
974,vr_K4VR_pal_static,False,196608,1536,128.0,195072,1526
975,vr_K5VR_static,False,1536,196608,0.008,-195072,1528
976,vr_K5VR_pal_static,False,196608,1536,128.0,195072,1532
977,vr_SP1a_static,False,1536,131072,0.012,-129536,1530
978,vr_SP1a_pal_static,False,131072,1024,128.0,130048,984
979,vr_MLVR_static,False,1024,262144,0.004,-261120,1021
980,vr_MLVR_pal_static,False,262144,2048,128.0,260096,2037
981,vr_KKRVR_static,False,2048,262144,0.008,-260096,2048
982,vr_KKRVR_pal_static,False,262144,2048,128.0,260096,2042
983,vr_KR3VR_static,False,2048,196608,0.01,-194560,2035
984,vr_KR3VR_pal_static,False,196608,1536,128.0,195072,1527
985,vr_IPVR_static,False,1536,262144,0.006,-260608,1531
986,vr_IPVR_pal_static,False,262144,2048,128.0,260096,2046
987,vr_KSVR_static,False,2048,131072,0.016,-129024,2041
988,vr_KSVR_pal_static,False,131072,1024,128.0,130048,1018
989,vr_GLVR_static,False,1024,131072,0.008,-130048,1019
990,vr_GLVR_pal_static,False,131072,1024,128.0,130048,1021
991,vr_ZRVR_static,False,1024,131072,0.008,-130048,1021
992,vr_ZRVR_pal_static,False,131072,1024,128.0,130048,1020
993,vr_DGVR_static,False,1024,131072,0.008,-130048,1019
994,vr_DGVR_pal_static,False,131072,1024,128.0,130048,1017
995,vr_ALVR_static,False,1024,131072,0.008,-130048,1020
996,vr_ALVR_pal_static,False,131072,1024,128.0,130048,1016
997,vr_NSVR_static,False,1024,131072,0.008,-130048,1021
998,vr_NSVR_pal_static,False,131072,1024,128.0,130048,1019
999,vr_LBVR_static,False,1024,262144,0.004,-261120,1018
1000,vr_LBVR_pal_static,False,262144,2048,128.0,260096,2045
1001,vr_TTVR_static,False,2048,196608,0.01,-194560,2044
1002,vr_TTVR_pal_static,False,196608,1536,128.0,195072,1525
1003,vr_FCVR_static,False,1536,131072,0.012,-129536,1529
1004,vr_FCVR_pal_static,False,131072,1024,128.0,130048,1021
1005,elf_message_field,False,1024,112,9.143,912,111
1006,elf_message_ydan,False,112,16,7.0,96,9
1013,spot00_scene,False,53888,172576,0.312,-118688,49457
1014,spot00_room_0,False,11552,86576,0.133,-75024,10665
1015,spot01_scene,False,7712,115024,0.067,-107312,7163
1016,spot01_room_0,False,46256,40672,1.137,5584,35137
1017,spot02_scene,False,10656,48256,0.221,-37600,10055
1018,spot02_room_0,False,6400,9952,0.643,-3552,5809
1019,spot02_room_1,False,24256,122768,0.198,-98512,21949
1020,spot03_scene,False,55984,46432,1.206,9552,43701
1021,spot03_room_0,False,49856,55680,0.895,-5824,47096
1022,spot03_room_1,False,30448,29952,1.017,496,25596
1023,spot04_scene,False,70960,70208,1.011,752,64621
1024,spot04_room_0,False,65424,111760,0.585,-46336,58215
1025,spot04_room_1,False,37520,34176,1.098,3344,31329
1026,spot04_room_2,False,20352,20592,0.988,-240,18266
1027,spot05_scene,False,31776,85344,0.372,-53568,29670
1028,spot05_room_0,False,41296,40704,1.015,592,37675
1029,spot06_scene,False,20704,111664,0.185,-90960,19647
1030,spot06_room_0,False,32576,42528,0.766,-9952,30768
1031,spot07_scene,False,33584,38944,0.862,-5360,32051
1032,spot07_room_0,False,33296,25328,1.315,7968,21855
1033,spot07_room_1,False,14576,51616,0.282,-37040,13326
1034,spot08_scene,False,23648,71328,0.332,-47680,22645
1035,spot08_room_0,False,752,33120,0.023,-32368,552
1036,spot09_scene,False,169904,69984,2.428,99920,66699
1037,spot09_room_0,False,70544,34752,2.03,35792,31694
1038,spot10_scene,False,43232,66608,0.649,-23376,39027
1039,spot10_room_0,False,19312,9712,1.988,9600,8835
1040,spot10_room_1,False,80624,33840,2.383,46784,31430
1041,spot10_room_2,False,4688,19440,0.241,-14752,3801
1042,spot10_room_3,False,481024,23216,20.72,457808,22595
1043,spot10_room_4,False,73248,9424,7.772,63824,7907
1044,spot10_room_5,False,26320,28656,0.918,-2336,23285
1045,spot10_room_6,False,5680,15088,0.376,-9408,4630
1046,spot10_room_7,False,10272,9664,1.063,608,7233
1047,spot10_room_8,False,1072,9840,0.109,-8768,757
1048,spot10_room_9,False,154480,15328,10.078,139152,14892
1049,spot11_scene,False,992,103648,0.01,-102656,751
1050,spot11_room_0,False,154464,51136,3.021,103328,42104
1051,spot12_scene,False,4848,65152,0.074,-60304,3976
1052,spot12_room_0,False,481008,71104,6.765,409904,61304
1053,spot12_room_1,False,15712,49312,0.319,-33600,13186
1054,spot13_scene,False,1600,24112,0.066,-22512,1212
1055,spot13_room_0,False,6048,2320,2.607,3728,1862
1056,spot13_room_1,False,222736,76352,2.917,146384,73317
1057,spot15_scene,False,105280,99584,1.057,5696,95597
1058,spot15_room_0,False,69440,53696,1.293,15744,45945
1059,spot16_scene,False,37632,125584,0.3,-87952,35008
1060,spot16_room_0,False,23568,44304,0.532,-20736,21814
1061,spot17_scene,False,15184,65248,0.233,-50064,14169
1062,spot17_room_0,False,29296,26752,1.095,2544,24166
1063,spot17_room_1,False,98112,74592,1.315,23520,65977
1064,spot18_scene,False,18432,42064,0.438,-23632,16574
1065,spot18_room_0,False,21776,75728,0.288,-53952,19581
1066,spot18_room_1,False,32880,25088,1.311,7792,23126
1067,spot18_room_2,False,24048,72112,0.333,-48064,22234
1068,spot18_room_3,False,33184,122096,0.272,-88912,30996
1069,ydan_scene,False,16,55840,0.0,-55824,10
1070,ydan_room_0,False,86336,86864,0.994,-528,83046
1071,ydan_room_1,False,112800,16896,6.676,95904,15870
1072,ydan_room_2,False,39680,24368,1.628,15312,22446
1073,ydan_room_3,False,32160,82352,0.391,-50192,28919
1074,ydan_room_4,False,56768,19504,2.911,37264,17640
1075,ydan_room_5,False,38992,33680,1.158,5312,30133
1076,ydan_room_6,False,24288,20224,1.201,4064,18484
1077,ydan_room_7,False,9216,35488,0.26,-26272,8634
1078,ydan_room_8,False,30416,3472,8.76,26944,2884
1079,ydan_room_9,False,37888,39072,0.97,-1184,35728
1080,ydan_room_10,False,46416,19968,2.325,26448,18117
1081,ydan_room_11,False,32336,29040,1.113,3296,26942
1082,ddan_scene,False,8320,86336,0.096,-78016,7714
1083,ddan_room_0,False,34608,112800,0.307,-78192,31975
1084,ddan_room_1,False,9344,39792,0.235,-30448,8499
1085,ddan_room_2,False,9360,32448,0.288,-23088,8730
1086,ddan_room_3,False,10320,56944,0.181,-46624,9529
1087,ddan_room_4,False,21840,39264,0.556,-17424,20583
1088,ddan_room_5,False,172608,24256,7.116,148352,23321
1089,ddan_room_6,False,86576,9392,9.218,77184,8719
1090,ddan_room_7,False,115056,30464,3.777,84592,27868
1091,ddan_room_8,False,40672,38304,1.062,2368,35473
1092,ddan_room_9,False,48256,46384,1.04,1872,43137
1093,ddan_room_10,False,9952,32528,0.306,-22576,8011
1094,ddan_room_11,False,122768,8240,14.899,114528,7504
1095,ddan_room_12,False,46432,34688,1.339,11744,32934
1096,ddan_room_13,False,55680,9424,5.908,46256,8946
1097,ddan_room_14,False,29952,9424,3.178,20528,8835
1098,ddan_room_15,False,70256,10544,6.663,59712,10074
1099,ddan_room_16,False,111760,21856,5.113,89904,20710
1100,bdan_scene,False,34176,88032,0.388,-53856,32115
1101,bdan_room_0,False,20592,16704,1.233,3888,14975
1102,bdan_room_1,False,85360,24512,3.482,60848,21984
1103,bdan_room_2,False,40704,37440,1.087,3264,32622
1104,bdan_room_3,False,111680,29280,3.814,82400,27522
1105,bdan_room_4,False,42528,16640,2.556,25888,14864
1106,bdan_room_5,False,38960,24720,1.576,14240,23466
1107,bdan_room_6,False,25328,16960,1.493,8368,15337
1108,bdan_room_7,False,51616,13520,3.818,38096,11923
1109,bdan_room_8,False,71328,14400,4.953,56928,12269
1110,bdan_room_9,False,33120,15408,2.15,17712,12112
1111,bdan_room_10,False,70032,14368,4.874,55664,12051
1112,bdan_room_11,False,34752,14832,2.343,19920,12026
1113,bdan_room_12,False,66608,15584,4.274,51024,13097
1114,bdan_room_13,False,9712,11136,0.872,-1424,8709
1115,bdan_room_14,False,33840,25040,1.351,8800,23183
1116,bdan_room_15,False,19440,9952,1.953,9488,8062
1117,Bmori1_scene,False,23216,90000,0.258,-66784,21401
1118,Bmori1_room_0,False,9424,56208,0.168,-46784,7712
1119,Bmori1_room_1,False,28656,23408,1.224,5248,21190
1120,Bmori1_room_2,False,15088,63872,0.236,-48784,13791
1121,Bmori1_room_3,False,9664,14816,0.652,-5152,7977
1122,Bmori1_room_4,False,9840,12992,0.757,-3152,8136
1123,Bmori1_room_5,False,15328,13776,1.113,1552,12555
1124,Bmori1_room_6,False,103664,37936,2.733,65728,35305
1125,Bmori1_room_7,False,51136,77792,0.657,-26656,47235
1126,Bmori1_room_8,False,65168,96944,0.672,-31776,62977
1127,Bmori1_room_9,False,71104,41312,1.721,29792,36938
1128,Bmori1_room_10,False,49312,21472,2.297,27840,19903
1129,Bmori1_room_11,False,24112,44000,0.548,-19888,23134
1130,Bmori1_room_12,False,2320,33760,0.069,-31440,1947
1131,Bmori1_room_13,False,76352,35504,2.151,40848,32678
1132,Bmori1_room_14,False,99584,23408,4.254,76176,21891
1133,Bmori1_room_15,False,53696,9952,5.395,43744,9133
1134,Bmori1_room_16,False,125632,20384,6.163,105248,19621
1135,Bmori1_room_17,False,44304,37104,1.194,7200,33508
1136,Bmori1_room_18,False,65264,4912,13.287,60352,4473
1137,Bmori1_room_19,False,26752,1280,20.9,25472,1062
1138,Bmori1_room_20,False,74592,4864,15.336,69728,4417
1139,Bmori1_room_21,False,41936,6000,6.989,35936,5496
1140,Bmori1_room_22,False,75728,7648,9.902,68080,7085
1141,HIDAN_scene,False,25088,108496,0.231,-83408,23268
1142,HIDAN_room_0,False,72112,29424,2.451,42688,25161
1143,HIDAN_room_1,False,122096,51504,2.371,70592,45676
1144,HIDAN_room_2,False,9840,65584,0.15,-55744,8780
1145,HIDAN_room_3,False,22640,9424,2.402,13216,7326
1146,HIDAN_room_4,False,9776,30960,0.316,-21184,8205
1147,HIDAN_room_5,False,22432,41696,0.538,-19264,16277
1148,HIDAN_room_6,False,108912,28560,3.813,80352,26280
1149,HIDAN_room_7,False,29376,14928,1.968,14448,13450
1150,HIDAN_room_8,False,51680,39648,1.303,12032,35377
1151,HIDAN_room_9,False,65488,34672,1.889,30816,28983
1152,HIDAN_room_10,False,9440,99360,0.095,-89920,7809
1153,HIDAN_room_11,False,30864,14304,2.158,16560,12522
1154,HIDAN_room_12,False,41520,11120,3.734,30400,9646
1155,HIDAN_room_13,False,28576,52112,0.548,-23536,24480
1156,HIDAN_room_14,False,14816,8704,1.702,6112,7058
1157,HIDAN_room_15,False,39616,4496,8.811,35120,3420
1158,HIDAN_room_16,False,34672,47584,0.729,-12912,30916
1159,HIDAN_room_17,False,99488,37232,2.672,62256,31449
1160,HIDAN_room_18,False,14272,15360,0.929,-1088,12370
1161,HIDAN_room_19,False,11136,16944,0.657,-5808,9540
1162,HIDAN_room_20,False,52192,27920,1.869,24272,25175
1163,HIDAN_room_21,False,8800,33920,0.259,-25120,6955
1164,HIDAN_room_22,False,4560,27376,0.167,-22816,3611
1165,HIDAN_room_23,False,47472,27936,1.699,19536,24951
1166,HIDAN_room_24,False,37184,21824,1.704,15360,17814
1167,HIDAN_room_25,False,15232,27360,0.557,-12128,12223
1168,HIDAN_room_26,False,16864,26784,0.63,-9920,14258
1169,MIZUsin_scene,False,27920,89136,0.313,-61216,25747
1170,MIZUsin_room_0,False,33984,89136,0.381,-55152,30936
1171,MIZUsin_room_1,False,27392,41424,0.661,-14032,24310
1172,MIZUsin_room_2,False,27936,23696,1.179,4240,22148
1173,MIZUsin_room_3,False,21824,26560,0.822,-4736,18900
1174,MIZUsin_room_4,False,27360,24608,1.112,2752,22096
1175,MIZUsin_room_5,False,26784,42560,0.629,-15776,23926
1176,MIZUsin_room_6,False,90000,45824,1.964,44176,44228
1177,MIZUsin_room_7,False,56256,21856,2.574,34400,19425
1178,MIZUsin_room_8,False,23392,56704,0.413,-33312,21167
1179,MIZUsin_room_9,False,64048,32944,1.944,31104,30243
1180,MIZUsin_room_10,False,14864,24688,0.602,-9824,12970
1181,MIZUsin_room_11,False,12976,18976,0.684,-6000,10664
1182,MIZUsin_room_12,False,13792,28208,0.489,-14416,12391
1183,MIZUsin_room_13,False,38080,2560,14.875,35520,2407
1184,MIZUsin_room_14,False,77824,28288,2.751,49536,25675
1185,MIZUsin_room_15,False,97136,29808,3.259,67328,28166
1186,MIZUsin_room_16,False,41360,15152,2.73,26208,14032
1187,MIZUsin_room_17,False,21472,35504,0.605,-14032,19538
1188,MIZUsin_room_18,False,43984,16640,2.643,27344,15471
1189,MIZUsin_room_19,False,33760,14640,2.306,19120,13613
1190,MIZUsin_room_20,False,35504,26688,1.33,8816,24781
1191,MIZUsin_room_21,False,23472,29856,0.786,-6384,21167
1192,MIZUsin_room_22,False,9872,37104,0.266,-27232,8759
1193,jyasinzou_scene,False,20384,105248,0.194,-84864,18779
1194,jyasinzou_room_0,False,37200,69616,0.534,-32416,33988
1195,jyasinzou_room_1,False,4928,37712,0.131,-32784,4484
1196,jyasinzou_room_2,False,1296,23472,0.055,-22176,1036
1197,jyasinzou_room_3,False,4864,15312,0.318,-10448,4308
1198,jyasinzou_room_4,False,6016,29312,0.205,-23296,4921
1199,jyasinzou_room_5,False,7648,98320,0.078,-90672,7150
1200,jyasinzou_room_6,False,55824,18416,3.031,37408,16458
1201,jyasinzou_room_7,False,86768,21776,3.985,64992,19348
1202,jyasinzou_room_8,False,16720,32944,0.508,-16224,15606
1203,jyasinzou_room_9,False,24112,24016,1.004,96,22321
1204,jyasinzou_room_10,False,82336,33184,2.481,49152,31475
1205,jyasinzou_room_11,False,19408,4112,4.72,15296,3530
1206,jyasinzou_room_12,False,33568,8416,3.989,25152,7472
1207,jyasinzou_room_13,False,20160,22704,0.888,-2544,18413
1208,jyasinzou_room_14,False,35088,19616,1.789,15472,18549
1209,jyasinzou_room_15,False,3328,33952,0.098,-30624,2941
1210,jyasinzou_room_16,False,39072,25024,1.561,14048,23036
1211,jyasinzou_room_17,False,19840,38480,0.516,-18640,18271
1212,jyasinzou_room_18,False,29040,23776,1.221,5264,22250
1213,jyasinzou_room_19,False,14576,24016,0.607,-9440,12527
1214,jyasinzou_room_20,False,78096,33216,2.351,44880,32261
1215,jyasinzou_room_21,False,75712,18016,4.202,57696,16967
1216,jyasinzou_room_22,False,94688,12400,7.636,82288,11206
1217,jyasinzou_room_23,False,28880,37392,0.772,-8512,25794
1218,jyasinzou_room_24,False,7008,25808,0.272,-18800,5501
1219,jyasinzou_room_25,False,162944,88992,1.831,73952,78119
1220,jyasinzou_room_26,False,2432,51968,0.047,-49536,2027
1221,jyasinzou_room_27,False,199824,22288,8.966,177536,17686
1222,jyasinzou_room_28,False,89328,35376,2.525,53952,32775
1223,HAKAdan_scene,False,89216,99264,0.899,-10048,83945
1224,HAKAdan_room_0,False,41312,45392,0.91,-4080,37371
1225,HAKAdan_room_1,False,23440,6896,3.399,16544,6235
1226,HAKAdan_room_2,False,26384,43488,0.607,-17104,23670
1227,HAKAdan_room_3,False,24544,10624,2.31,13920,9364
1228,HAKAdan_room_4,False,42480,7264,5.848,35216,6105
1229,HAKAdan_room_5,False,45760,23232,1.97,22528,21583
1230,HAKAdan_room_6,False,21840,30192,0.723,-8352,19779
1231,HAKAdan_room_7,False,56528,6880,8.216,49648,6384
1232,HAKAdan_room_8,False,32736,20640,1.586,12096,18446
1233,HAKAdan_room_9,False,24496,52368,0.468,-27872,22952
1234,HAKAdan_room_10,False,18864,30704,0.614,-11840,16966
1235,HAKAdan_room_11,False,28048,15968,1.757,12080,14364
1236,HAKAdan_room_12,False,2560,22352,0.115,-19792,2440
1237,HAKAdan_room_13,False,28256,4128,6.845,24128,3557
1238,HAKAdan_room_14,False,29744,22784,1.305,6960,20797
1239,HAKAdan_room_15,False,15056,29376,0.513,-14320,13966
1240,HAKAdan_room_16,False,35360,10544,3.354,24816,8981
1241,HAKAdan_room_17,False,16576,11744,1.411,4832,10689
1242,HAKAdan_room_18,False,14640,54032,0.271,-39392,14049
1243,HAKAdan_room_19,False,26432,11648,2.269,14784,11058
1244,HAKAdan_room_20,False,29856,7744,3.855,22112,6838
1245,HAKAdan_room_21,False,37104,46512,0.798,-9408,33931
1246,HAKAdan_room_22,False,3264,10672,0.306,-7408,2697
1247,HAKAdanCH_scene,False,179248,50576,3.544,128672,44589
1248,HAKAdanCH_room_0,False,55328,87840,0.63,-32512,51819
1249,HAKAdanCH_room_1,False,29344,45360,0.647,-16016,27793
1250,HAKAdanCH_room_2,False,20880,12640,1.652,8240,11283
1251,HAKAdanCH_room_3,False,10432,7360,1.417,3072,6287
1252,HAKAdanCH_room_4,False,20784,9376,2.217,11408,8478
1253,HAKAdanCH_room_5,False,31072,10640,2.92,20432,9902
1254,HAKAdanCH_room_6,False,18144,11936,1.52,6208,11178
1255,ice_doukutu_scene,False,23152,71360,0.324,-48208,21784
1256,ice_doukutu_room_0,False,16336,34432,0.474,-18096,15443
1257,ice_doukutu_room_1,False,13872,50480,0.275,-36608,12581
1258,ice_doukutu_room_2,False,23248,23296,0.998,-48,22154
1259,ice_doukutu_room_3,False,23088,32912,0.702,-9824,21981
1260,ice_doukutu_room_4,False,34480,30288,1.138,4192,28392
1261,ice_doukutu_room_5,False,32336,34944,0.925,-2608,30883
1262,ice_doukutu_room_6,False,28368,16816,1.687,11552,15551
1263,ice_doukutu_room_7,False,992,22768,0.044,-21776,818
1264,ice_doukutu_room_8,False,154480,6432,24.017,148048,6173
1265,ice_doukutu_room_9,False,88000,34448,2.555,53552,32719
1266,ice_doukutu_room_10,False,16496,17376,0.949,-880,15041
1267,ice_doukutu_room_11,False,24208,22608,1.071,1600,20719
1268,men_scene,False,37328,70848,0.527,-33520,33946
1269,men_room_0,False,29024,65424,0.444,-36400,25717
1270,men_room_1,False,16464,37488,0.439,-21024,13943
1271,men_room_2,False,24608,20560,1.197,4048,18726
1272,men_room_3,False,16960,31824,0.533,-14864,15141
1273,men_room_4,False,13600,41440,0.328,-27840,12475
1274,men_room_5,False,14464,20512,0.705,-6048,12446
1275,men_room_6,False,15472,32640,0.474,-17168,12818
1276,men_room_7,False,14384,33472,0.43,-19088,11694
1277,men_room_8,False,14336,33328,0.43,-18992,11658
1278,men_room_9,False,15568,14448,1.078,1120,12845
1279,men_room_10,False,11088,23632,0.469,-12544,10388
1280,ganontika_scene,False,25056,137168,0.183,-112112,24140
1281,ganontika_room_0,False,9952,37392,0.266,-27440,8284
1282,ganontika_room_1,False,99264,117200,0.847,-17936,92785
1283,ganontika_room_2,False,45248,30688,1.474,14560,28211
1284,ganontika_room_3,False,6848,39488,0.173,-32640,6055
1285,ganontika_room_4,False,43280,31888,1.357,11392,29511
1286,ganontika_room_5,False,10560,29984,0.352,-19424,9674
1287,ganontika_room_6,False,7232,64608,0.112,-57376,6409
1288,ganontika_room_7,False,23136,31888,0.726,-8752,21078
1289,ganontika_room_8,False,30064,36896,0.815,-6832,27205
1290,ganontika_room_9,False,6832,47136,0.145,-40304,6001
1291,ganontika_room_10,False,20576,27584,0.746,-7008,18494
1292,ganontika_room_11,False,52064,26960,1.931,25104,25130
1293,ganontika_room_12,False,30624,45680,0.67,-15056,28788
1294,ganontika_room_13,False,15680,32064,0.489,-16384,13809
1295,ganontika_room_14,False,22304,41424,0.538,-19120,19840
1296,ganontika_room_15,False,4016,32064,0.125,-28048,3584
1297,ganontika_room_16,False,22848,11824,1.932,11024,10709
1298,ganontika_room_17,False,29296,34336,0.853,-5040,26278
1299,ganontika_room_18,False,10368,50912,0.204,-40544,9079
1300,ganontika_room_19,False,11472,32064,0.358,-20592,10428
1301,market_day_scene,False,4112,9840,0.418,-5728,3626
1302,market_day_room_0,False,8288,22640,0.366,-14352,6920
1303,market_night_scene,False,22608,9776,2.313,12832,8328
1304,market_night_room_0,False,19600,22432,0.874,-2832,16703
1311,kenjyanoma_scene,False,33904,14576,2.326,19328,12306
1312,kenjyanoma_room_0,False,24976,78096,0.32,-53120,23791
1313,tokinoma_scene,False,38416,75680,0.508,-37264,32975
1314,tokinoma_room_0,False,23728,94688,0.251,-70960,22247
1315,tokinoma_room_1,False,24032,28880,0.832,-4848,21951
1318,link_home_scene,False,33216,7008,4.74,26208,5701
1319,link_home_room_0,False,18000,162944,0.11,-144944,16113
1320,kokiri_shop_scene,False,12496,2432,5.138,10064,1945
1321,kokiri_shop_room_0,False,37264,199824,0.186,-162560,31805
1322,kokiri_home_scene,False,25776,3264,7.897,22512,2703
1323,kokiri_home_room_0,False,88944,179248,0.496,-90304,80691
1324,kakusiana_scene,False,52000,55328,0.94,-3328,49656
1325,kakusiana_room_0,False,22208,29344,0.757,-7136,20556
1326,kakusiana_room_1,False,35360,20880,1.693,14480,19661
1327,kakusiana_room_2,False,71168,10432,6.822,60736,9455
1328,kakusiana_room_3,False,34400,20784,1.655,13616,20033
1329,kakusiana_room_4,False,50496,31072,1.625,19424,29687
1330,kakusiana_room_5,False,23280,18144,1.283,5136,16896
1331,kakusiana_room_6,False,32896,23152,1.421,9744,21501
1332,kakusiana_room_7,False,30320,16336,1.856,13984,15638
1333,kakusiana_room_8,False,34960,13872,2.52,21088,12313
1334,kakusiana_room_9,False,16992,23248,0.731,-6256,15836
1335,kakusiana_room_10,False,22768,23088,0.986,-320,21715
1336,kakusiana_room_11,False,6480,34480,0.188,-28000,5770
1337,kakusiana_room_12,False,34384,32336,1.063,2048,30842
1338,kakusiana_room_13,False,17376,28368,0.613,-10992,16314
1339,entra_scene,False,22784,992,22.968,21792,739
1340,entra_room_0,False,1648,154480,0.011,-152832,1295
1341,moribossroom_scene,False,189008,6400,29.532,182608,5631
1342,moribossroom_room_0,False,3744,24256,0.154,-20512,3119
1343,moribossroom_room_1,False,176064,55984,3.145,120080,46827
1344,syatekijyou_scene,False,3648,49856,0.073,-46208,2686
1345,syatekijyou_room_0,False,12320,30448,0.405,-18128,10853
1346,shop1_scene,False,20672,752,27.489,19920,582
1347,shop1_room_0,False,19456,169904,0.115,-150448,16370
1348,hairal_niwa_scene,False,17008,70544,0.241,-53536,15351
1349,hairal_niwa_room_0,False,28640,43232,0.662,-14592,25637
1350,ganon_tou_scene,False,1296,19312,0.067,-18016,990
1351,ganon_tou_room_0,False,169376,80624,2.101,88752,73982
1354,market_alley_scene,False,57344,4688,12.232,52656,3672
1355,market_alley_room_0,False,14608,481024,0.03,-466416,14389
1356,spot20_scene,False,2704,73248,0.037,-70544,2046
1357,spot20_room_0,False,30928,26320,1.175,4608,24364
1358,market_ruins_scene,False,34832,5680,6.132,29152,4325
1359,market_ruins_room_0,False,17104,10272,1.665,6832,7668
1360,entra_n_scene,False,52640,1072,49.104,51568,727
1361,entra_n_room_0,False,16400,154480,0.106,-138080,16002
1362,enrui_scene,False,928,992,0.935,-64,592
1363,enrui_room_0,False,156112,154464,1.011,1648,22024
1364,market_alley_n_scene,False,912,4848,0.188,-3936,628
1365,market_alley_n_room_0,False,156128,481008,0.325,-324880,21092
1366,hiral_demo_scene,False,1008,15696,0.064,-14688,660
1367,hiral_demo_room_0,False,179808,1600,112.38,178208,925
1368,kokiri_home3_scene,False,1456,6048,0.241,-4592,822
1369,kokiri_home3_room_0,False,158768,222736,0.713,-63968,29044
1370,malon_stable_scene,False,1648,1648,1.0,0,1142
1371,malon_stable_room_0,False,166240,189008,0.88,-22768,45707
1372,kakariko_scene,False,3344,3744,0.893,-400,2061
1373,kakariko_room_0,False,159648,176064,0.907,-16416,31245
1374,bdan_boss_scene,False,3824,3648,1.048,176,2657
1375,bdan_boss_room_0,False,182000,12320,14.773,169680,10266
1376,bdan_boss_room_1,False,1664,20672,0.08,-19008,1333
1377,FIRE_bs_scene,False,210592,19456,10.824,191136,16322
1378,FIRE_bs_room_0,False,14880,17008,0.875,-2128,12552
1379,FIRE_bs_room_1,False,97984,28640,3.421,69344,25614
1380,hut_scene,False,10336,1296,7.975,9040,896
1381,hut_room_0,False,20016,169376,0.118,-149360,16016
1382,daiyousei_izumi_scene,False,15840,57344,0.276,-41504,14684
1383,daiyousei_izumi_room_0,False,5952,14608,0.407,-8656,5254
1384,hakaana_scene,False,28656,2704,10.598,25952,2332
1385,hakaana_room_0,False,26608,30928,0.86,-4320,24603
1386,yousei_izumi_tate_scene,False,10112,34832,0.29,-24720,8728
1387,yousei_izumi_tate_room_0,False,10720,17104,0.627,-6384,9644
1388,yousei_izumi_yoko_scene,False,24400,52640,0.464,-28240,22533
1389,yousei_izumi_yoko_room_0,False,6752,16400,0.412,-9648,5833
1390,golon_scene,False,17520,928,18.879,16592,736
1391,golon_room_0,False,45808,156112,0.293,-110304,42902
1392,zoora_scene,False,67504,912,74.018,66592,742
1393,zoora_room_0,False,32464,156128,0.208,-123664,30448
1394,drag_scene,False,30576,1008,30.333,29568,827
1395,drag_room_0,False,30800,179808,0.171,-149008,25723
1396,alley_shop_scene,False,30512,1456,20.956,29056,1255
1397,alley_shop_room_0,False,37072,158768,0.233,-121696,34611
1398,night_shop_scene,False,35600,1648,21.602,33952,1446
1399,night_shop_room_0,False,39840,166240,0.24,-126400,34421
1400,impa_scene,False,42912,3344,12.833,39568,2795
1401,impa_room_0,False,27616,159648,0.173,-132032,25407
1402,labo_scene,False,22816,3824,5.967,18992,3313
1403,labo_room_0,False,31776,182000,0.175,-150224,29764
1404,tent_scene,False,24192,1664,14.538,22528,1207
1405,tent_room_0,False,36080,210592,0.171,-174512,29779
1406,nakaniwa_scene,False,4048,14880,0.272,-10832,3627
1407,nakaniwa_room_0,False,32320,97984,0.33,-65664,30545
1408,ddan_boss_scene,False,15808,10336,1.529,5472,9882
1409,ddan_boss_room_0,False,46848,20016,2.341,26832,17296
1410,ddan_boss_room_1,False,6832,15840,0.431,-9008,5856
1411,ydan_boss_scene,False,231760,5952,38.938,225808,5846
1412,ydan_boss_room_0,False,5136,28656,0.179,-23520,4451
1413,ydan_boss_room_1,False,200544,26608,7.537,173936,25686
1414,HAKAdan_bs_scene,False,74112,10112,7.329,64000,9180
1415,HAKAdan_bs_room_0,False,52912,10720,4.936,42192,9583
1416,HAKAdan_bs_room_1,False,2112,24400,0.087,-22288,1696
1417,MIZUsin_bs_scene,False,173440,6752,25.687,166688,5175
1418,MIZUsin_bs_room_0,False,57968,17520,3.309,40448,16912
1419,MIZUsin_bs_room_1,False,29376,45808,0.641,-16432,27923
1420,ganon_scene,False,26400,67504,0.391,-41104,25328
1421,ganon_room_0,False,33968,32464,1.046,1504,28803
1422,ganon_room_1,False,36064,30576,1.179,5488,26840
1423,ganon_room_2,False,17536,30800,0.569,-13264,15817
1424,ganon_room_3,False,17488,30512,0.573,-13024,16299
1425,ganon_room_4,False,31408,37072,0.847,-5664,27950
1426,ganon_room_5,False,5344,35600,0.15,-30256,4794
1427,ganon_room_6,False,338672,39840,8.501,298832,31832
1428,ganon_room_7,False,75488,42912,1.759,32576,40546
1429,ganon_room_8,False,26464,27616,0.958,-1152,22481
1430,ganon_room_9,False,5376,22816,0.236,-17440,4662
1431,ganon_boss_scene,False,338704,31776,10.659,306928,29789
1432,ganon_boss_room_0,False,5264,24192,0.218,-18928,4408
1433,jyasinboss_scene,False,338672,36080,9.387,302592,31197
1434,jyasinboss_room_0,False,137152,4048,33.881,133104,3801
1435,jyasinboss_room_1,False,37312,32320,1.154,4992,30151
1436,jyasinboss_room_2,False,117168,15808,7.412,101360,14493
1437,jyasinboss_room_3,False,30688,46848,0.655,-16160,28579
1438,kokiri_home4_scene,False,39312,6832,5.754,32480,5860
1439,kokiri_home4_room_0,False,31888,231760,0.138,-199872,31637
1440,kokiri_home5_scene,False,30016,5136,5.844,24880,4233
1441,kokiri_home5_room_0,False,64496,200544,0.322,-136048,54235
1442,ganon_final_scene,False,31888,74112,0.43,-42224,30673
1443,ganon_final_room_0,False,36976,52912,0.699,-15936,34761
1444,kakariko3_scene,False,47248,2112,22.371,45136,1659
1445,kakariko3_room_0,False,27504,173440,0.159,-145936,24189
1448,hakasitarelay_scene,False,26960,57968,0.465,-31008,25263
1449,hakasitarelay_room_0,False,45936,29376,1.564,16560,27773
1450,hakasitarelay_room_1,False,32064,26400,1.215,5664,23972
1451,hakasitarelay_room_2,False,41376,33968,1.218,7408,31447
1452,hakasitarelay_room_3,False,32064,36064,0.889,-4000,29254
1453,hakasitarelay_room_4,False,11808,17536,0.673,-5728,10703
1454,hakasitarelay_room_5,False,34464,17488,1.971,16976,15803
1455,hakasitarelay_room_6,False,50800,31408,1.617,19392,28615
1456,shrine_scene,False,32064,5344,6.0,26720,4799
1457,shrine_room_0,False,53392,338672,0.158,-285280,50833
1458,turibori_scene,False,26640,75488,0.353,-48848,25031
1459,turibori_room_0,False,55584,26464,2.1,29120,23421
1460,shrine_n_scene,False,19776,5376,3.679,14400,4729
1461,shrine_n_room_0,False,29360,338704,0.087,-309344,25867
1462,shrine_r_scene,False,15952,5264,3.03,10688,4713
1463,shrine_r_room_0,False,45840,338672,0.135,-292832,39323
1464,hakaana2_scene,False,14624,53392,0.274,-38768,13651
1465,hakaana2_room_0,False,20032,26640,0.752,-6608,16245
1466,gerudoway_scene,False,50528,55584,0.909,-5056,44126
1467,gerudoway_room_0,False,87536,19776,4.426,67760,17573
1468,gerudoway_room_1,False,45776,29360,1.559,16416,27342
1469,gerudoway_room_2,False,12688,15952,0.795,-3264,10712
1470,gerudoway_room_3,False,7264,45840,0.158,-38576,6025
1471,gerudoway_room_4,False,9296,14624,0.636,-5328,8492
1472,gerudoway_room_5,False,10592,20032,0.529,-9440,9960
1473,hairal_niwa_n_scene,False,11904,37104,0.321,-25200,11158
1474,hairal_niwa_n_room_0,False,37104,13856,2.678,23248,12859
1475,bowling_scene,False,13856,60192,0.23,-46336,12877
1476,bowling_room_0,False,60192,25056,2.402,35136,23014
1477,hakaana_ouke_scene,False,25056,19168,1.307,5888,16846
1478,hakaana_ouke_room_0,False,19168,43008,0.446,-23840,17110
1479,hakaana_ouke_room_1,False,43008,18432,2.333,24576,15882
1480,hakaana_ouke_room_2,False,18432,24848,0.742,-6416,16340
1481,hylia_labo_scene,False,24848,69776,0.356,-44928,23427
1482,hylia_labo_room_0,False,69776,30160,2.314,39616,28643
1483,souko_scene,False,30160,27664,1.09,2496,24855
1484,souko_room_0,False,27664,38208,0.724,-10544,25076
1485,souko_room_1,False,38208,42032,0.909,-3824,32334
1486,souko_room_2,False,42032,33152,1.268,8880,29310
1487,miharigoya_scene,False,33152,50512,0.656,-17360,32208
1488,miharigoya_room_0,False,50512,15792,3.199,34720,14551
1489,mahouya_scene,False,15792,43552,0.363,-27760,15009
1490,mahouya_room_0,False,43552,27280,1.596,16272,26697
1491,takaraya_scene,False,27280,29104,0.937,-1824,23911
1492,takaraya_room_0,False,29104,40384,0.721,-11280,26316
1493,takaraya_room_1,False,40384,8192,4.93,32192,6692
1494,takaraya_room_2,False,8192,8240,0.994,-48,5130
1495,takaraya_room_3,False,8240,10272,0.802,-2032,5077
1496,takaraya_room_4,False,10272,12320,0.834,-2048,7504
1497,takaraya_room_5,False,12320,12288,1.003,32,9646
1498,takaraya_room_6,False,12288,11008,1.116,1280,9684
1499,ganon_sonogo_scene,False,11008,32528,0.338,-21520,10008
1500,ganon_sonogo_room_0,False,32528,32384,1.004,144,29125
1501,ganon_sonogo_room_1,False,32384,31664,1.023,720,26117
1502,ganon_sonogo_room_2,False,31664,36000,0.88,-4336,26159
1503,ganon_sonogo_room_3,False,36000,22080,1.63,13920,17838
1504,ganon_sonogo_room_4,False,22080,36080,0.612,-14000,17460
1505,ganon_demo_scene,False,36080,36976,0.976,-896,34967
1506,ganon_demo_room_0,False,36976,16720,2.211,20256,15875
1509,face_shop_scene,False,16720,880,19.0,15840,673
1510,face_shop_room_0,False,880,190016,0.005,-189136,597
1511,kinsuta_scene,False,190016,5648,33.643,184368,4247
1512,kinsuta_room_0,False,5648,57504,0.098,-51856,4673
1513,ganontikasonogo_scene,False,57504,19200,2.995,38304,17768
1514,ganontikasonogo_room_0,False,19200,97152,0.198,-77952,17974
1515,ganontikasonogo_room_1,False,97152,40736,2.385,56416,35916
1518,bump_texture_static,False,40736,1024,39.781,39712,857
1519,anime_model_1_static,False,1024,16,64.0,1008,0
1531,softsprite_matrix_static,False,16,64,0.25,-48,2
