Index,File,Are equals,Size in baserom,Size in other_baserom,Size proportion,Size difference,Bytes different
0,makerom,False,4192,4192,1.0,0,20
1,boot,False,25552,73488,0.348,-47936,22197
2,dmadata,False,24416,24768,0.986,-352,17581
3,Audiobank,False,117328,179648,0.653,-62320,48124
4,Audioseq,False,325264,326272,0.997,-1008,189473
5,Audiotable,False,4590288,4526992,1.014,63296,991374
7,icon_item_static,False,559264,564384,0.991,-5120,134905
11,icon_item_gameover_static,False,13056,15488,0.843,-2432,3186
15,item_name_static,False,251904,377856,0.667,-125952,111119
16,map_name_static,False,137216,205824,0.667,-68608,72653
17,do_action_static,False,22272,33408,0.667,-11136,6356
20,nes_font_static,False,17792,17920,0.993,-128,93
21,nes_message_data_static,False,229680,229664,1.0,16,205035
24,staff_message_data_static,False,3936,3920,1.004,16,1511
28,code,False,1064240,1290032,0.825,-225792,956030
29,ovl_title,False,2496,2960,0.843,-464,2223
30,ovl_select,False,11616,12384,0.938,-768,9492
31,ovl_opening,False,352,336,1.048,16,203
32,ovl_file_choose,False,65312,64192,1.017,1120,54744
33,ovl_kaleido_scope,False,117136,125312,0.935,-8176,95281
34,ovl_player_actor,False,157024,157840,0.995,-816,137230
35,ovl_map_mark_data,False,27488,27360,1.005,128,1145
36,ovl_En_Test,False,22704,22704,1.0,0,18929
37,ovl_Arms_Hook,False,3424,3600,0.951,-176,2861
38,ovl_Arrow_Fire,False,7872,8128,0.969,-256,6819
39,ovl_Arrow_Ice,False,7904,8160,0.969,-256,6840
40,ovl_Arrow_Light,False,7920,8176,0.969,-256,6720
41,ovl_Bg_Bdan_Objects,False,4816,4976,0.968,-160,4304
42,ovl_Bg_Bdan_Switch,False,5168,5440,0.95,-272,4418
43,ovl_Bg_Bom_Guard,False,544,640,0.85,-96,472
44,ovl_Bg_Bombwall,False,2240,2448,0.915,-208,1889
45,ovl_Bg_Bowl_Wall,False,2432,2688,0.905,-256,2105
46,ovl_Bg_Breakwall,False,3696,3792,0.975,-96,2975
47,ovl_Bg_Ddan_Jd,False,1616,1600,1.01,16,1355
48,ovl_Bg_Ddan_Kd,False,2288,2320,0.986,-32,1954
49,ovl_Bg_Dodoago,False,3392,3520,0.964,-128,2814
50,ovl_Bg_Dy_Yoseizo,False,11600,12528,0.926,-928,10581
51,ovl_Bg_Ganon_Otyuka,False,9792,10304,0.95,-512,8598
52,ovl_Bg_Gate_Shutter,False,1152,1376,0.837,-224,1026
53,ovl_Bg_Gjyo_Bridge,False,1280,1392,0.92,-112,1103
54,ovl_Bg_Gnd_Darkmeiro,False,1984,2192,0.905,-208,1325
55,ovl_Bg_Gnd_Firemeiro,False,1344,1504,0.894,-160,1056
56,ovl_Bg_Gnd_Iceblock,False,4336,4512,0.961,-176,3668
57,ovl_Bg_Gnd_Nisekabe,False,368,368,1.0,0,205
58,ovl_Bg_Gnd_Soulmeiro,False,2144,2288,0.937,-144,1794
59,ovl_Bg_Haka,False,1728,1856,0.931,-128,1474
60,ovl_Bg_Haka_Gate,False,4224,4544,0.93,-320,3723
61,ovl_Bg_Haka_Huta,False,2720,2688,1.012,32,2188
62,ovl_Bg_Haka_Megane,False,1024,1008,1.016,16,784
63,ovl_Bg_Haka_MeganeBG,False,1728,1712,1.009,16,1446
64,ovl_Bg_Haka_Sgami,False,3104,3104,1.0,0,2151
65,ovl_Bg_Haka_Ship,False,2624,2976,0.882,-352,2322
66,ovl_Bg_Haka_Trap,False,5584,5552,1.006,32,4677
67,ovl_Bg_Haka_Tubo,False,2592,2736,0.947,-144,2159
68,ovl_Bg_Haka_Water,False,2016,2240,0.9,-224,1799
69,ovl_Bg_Haka_Zou,False,4592,4560,1.007,32,3811
70,ovl_Bg_Heavy_Block,False,6384,6672,0.957,-288,5498
71,ovl_Bg_Hidan_Curtain,False,2720,3200,0.85,-480,2415
72,ovl_Bg_Hidan_Dalm,False,2128,2112,1.008,16,1646
73,ovl_Bg_Hidan_Firewall,False,1888,2016,0.937,-128,1548
74,ovl_Bg_Hidan_Fslift,False,1232,1200,1.027,32,1035
75,ovl_Bg_Hidan_Fwbig,False,3296,3408,0.967,-112,2856
76,ovl_Bg_Hidan_Hamstep,False,3728,4336,0.86,-608,3237
77,ovl_Bg_Hidan_Hrock,False,2096,2096,1.0,0,1548
78,ovl_Bg_Hidan_Kousi,False,1408,1728,0.815,-320,1229
79,ovl_Bg_Hidan_Kowarerukabe,False,3792,4192,0.905,-400,3172
80,ovl_Bg_Hidan_Rock,False,4336,4480,0.968,-144,3719
81,ovl_Bg_Hidan_Rsekizou,False,3040,3264,0.931,-224,2515
82,ovl_Bg_Hidan_Sekizou,False,5200,5392,0.964,-192,3597
83,ovl_Bg_Hidan_Sima,False,3872,4080,0.949,-208,3349
84,ovl_Bg_Hidan_Syoku,False,1120,1104,1.014,16,916
85,ovl_Bg_Ice_Objects,False,3904,3888,1.004,16,3163
86,ovl_Bg_Ice_Shelter,False,4656,4992,0.933,-336,3883
87,ovl_Bg_Ice_Shutter,False,1136,1120,1.014,16,590
88,ovl_Bg_Ice_Turara,False,2096,2080,1.008,16,1703
89,ovl_Bg_Ingate,False,912,1056,0.864,-144,779
90,ovl_Bg_Jya_1flift,False,1680,1888,0.89,-208,1441
91,ovl_Bg_Jya_Amishutter,False,912,1056,0.864,-144,782
92,ovl_Bg_Jya_Bigmirror,False,2112,2752,0.767,-640,1736
93,ovl_Bg_Jya_Block,False,624,768,0.812,-144,547
94,ovl_Bg_Jya_Bombchuiwa,False,2864,3328,0.861,-464,2417
95,ovl_Bg_Jya_Bombiwa,False,1472,1872,0.786,-400,1266
96,ovl_Bg_Jya_Cobra,False,7456,8320,0.896,-864,6756
97,ovl_Bg_Jya_Goroiwa,False,1920,1872,1.026,48,1553
98,ovl_Bg_Jya_Haheniron,False,2032,2016,1.008,16,1260
99,ovl_Bg_Jya_Ironobj,False,3504,3744,0.936,-240,3012
100,ovl_Bg_Jya_Kanaami,False,944,1120,0.843,-176,813
101,ovl_Bg_Jya_Lift,False,1360,1424,0.955,-64,1136
102,ovl_Bg_Jya_Megami,False,4576,4880,0.938,-304,3831
103,ovl_Bg_Jya_Zurerukabe,False,1712,2096,0.817,-384,1533
104,ovl_Bg_Menkuri_Eye,False,1168,1328,0.88,-160,1010
105,ovl_Bg_Menkuri_Kaiten,False,400,384,1.042,16,293
106,ovl_Bg_Menkuri_Nisekabe,False,336,336,1.0,0,165
107,ovl_Bg_Mizu_Bwall,False,5328,6064,0.879,-736,4640
108,ovl_Bg_Mizu_Movebg,False,4496,4624,0.972,-128,3727
109,ovl_Bg_Mizu_Shutter,False,2048,2192,0.934,-144,1801
110,ovl_Bg_Mizu_Uzu,False,464,464,1.0,0,297
111,ovl_Bg_Mizu_Water,False,3280,3792,0.865,-512,2967
112,ovl_Bg_Mjin,False,992,1088,0.912,-96,860
113,ovl_Bg_Mori_Bigst,False,2352,3136,0.75,-784,2103
114,ovl_Bg_Mori_Elevator,False,2800,3424,0.818,-624,2439
115,ovl_Bg_Mori_Hashigo,False,2240,2816,0.795,-576,1929
116,ovl_Bg_Mori_Hashira4,False,1408,1888,0.746,-480,1252
117,ovl_Bg_Mori_Hineri,False,3280,3696,0.887,-416,2911
118,ovl_Bg_Mori_Idomizu,False,1600,1920,0.833,-320,1371
119,ovl_Bg_Mori_Kaitenkabe,False,1632,1968,0.829,-336,1369
120,ovl_Bg_Mori_Rakkatenjo,False,2416,3232,0.748,-816,2173
121,ovl_Bg_Po_Event,False,7728,7824,0.988,-96,5075
122,ovl_Bg_Po_Syokudai,False,2384,2608,0.914,-224,2040
123,ovl_Bg_Pushbox,False,768,880,0.873,-112,650
124,ovl_Bg_Relay_Objects,False,1968,1936,1.017,32,1621
125,ovl_Bg_Spot00_Break,False,416,416,1.0,0,280
126,ovl_Bg_Spot00_Hanebasi,False,4368,4672,0.935,-304,3727
127,ovl_Bg_Spot01_Fusya,False,672,800,0.84,-128,579
128,ovl_Bg_Spot01_Idohashira,False,3072,3584,0.857,-512,2610
129,ovl_Bg_Spot01_Idomizu,False,784,928,0.845,-144,541
130,ovl_Bg_Spot01_Idosoko,False,528,704,0.75,-176,443
131,ovl_Bg_Spot01_Objects2,False,1216,1312,0.927,-96,858
132,ovl_Bg_Spot02_Objects,False,4944,5248,0.942,-304,4313
133,ovl_Bg_Spot03_Taki,False,2288,2448,0.935,-160,1365
134,ovl_Bg_Spot05_Soko,False,800,784,1.02,16,640
135,ovl_Bg_Spot06_Objects,False,5136,5296,0.97,-160,4268
136,ovl_Bg_Spot07_Taki,False,1472,1696,0.868,-224,1255
137,ovl_Bg_Spot08_Bakudankabe,False,1696,1680,1.01,16,711
138,ovl_Bg_Spot08_Iceblock,False,4160,4480,0.929,-320,3710
139,ovl_Bg_Spot09_Obj,False,1296,1696,0.764,-400,912
140,ovl_Bg_Spot11_Bakudankabe,False,1600,1648,0.971,-48,636
141,ovl_Bg_Spot11_Oasis,False,1840,1952,0.943,-112,1519
142,ovl_Bg_Spot12_Gate,False,1040,1168,0.89,-128,896
143,ovl_Bg_Spot12_Saku,False,1216,1344,0.905,-128,1056
144,ovl_Bg_Spot15_Rrbox,False,3552,3824,0.929,-272,3106
145,ovl_Bg_Spot15_Saku,False,832,992,0.839,-160,720
146,ovl_Bg_Spot16_Bombstone,False,5440,6160,0.883,-720,4655
147,ovl_Bg_Spot16_Doughnut,False,1456,1920,0.758,-464,1293
148,ovl_Bg_Spot17_Bakudankabe,False,1760,2112,0.833,-352,882
149,ovl_Bg_Spot17_Funen,False,592,784,0.755,-192,509
150,ovl_Bg_Spot18_Basket,False,4080,4208,0.97,-128,3308
151,ovl_Bg_Spot18_Futa,False,416,400,1.04,16,316
152,ovl_Bg_Spot18_Obj,False,2256,2752,0.82,-496,1999
153,ovl_Bg_Spot18_Shutter,False,1360,1344,1.012,16,1121
154,ovl_Bg_Sst_Floor,False,1376,1520,0.905,-144,1210
155,ovl_Bg_Toki_Hikari,False,3488,3904,0.893,-416,2896
156,ovl_Bg_Toki_Swd,False,5712,5824,0.981,-112,2682
157,ovl_Bg_Treemouth,False,5712,5856,0.975,-144,4271
158,ovl_Bg_Umajump,False,400,384,1.042,16,302
159,ovl_Bg_Vb_Sima,False,1808,1952,0.926,-144,1539
160,ovl_Bg_Ydan_Hasi,False,1968,2112,0.932,-144,1699
161,ovl_Bg_Ydan_Maruta,False,1760,1744,1.009,16,1373
162,ovl_Bg_Ydan_Sp,False,6000,6160,0.974,-160,5006
163,ovl_Bg_Zg,False,1136,1392,0.816,-256,1002
164,ovl_Boss_Dodongo,False,39648,39984,0.992,-336,34783
165,ovl_Boss_Fd,False,29488,30896,0.954,-1408,25773
166,ovl_Boss_Fd2,False,15664,16896,0.927,-1232,13260
167,ovl_Boss_Ganon,False,139888,142160,0.984,-2272,119862
168,ovl_Boss_Ganon2,False,70384,72672,0.969,-2288,57350
169,ovl_Boss_Ganondrof,False,19824,21456,0.924,-1632,17038
170,ovl_Boss_Goma,False,24448,24816,0.985,-368,19235
171,ovl_Boss_Mo,False,46496,49088,0.947,-2592,38219
172,ovl_Boss_Sst,False,50464,50880,0.992,-416,43849
173,ovl_Boss_Tw,False,77952,80752,0.965,-2800,69413
174,ovl_Boss_Va,False,59376,60560,0.98,-1184,51591
175,ovl_Demo_6K,False,11536,12672,0.91,-1136,10469
176,ovl_Demo_Du,False,14304,14816,0.965,-512,11705
177,ovl_Demo_Ec,False,14432,15008,0.962,-576,11815
178,ovl_Demo_Effect,False,23296,25664,0.908,-2368,20600
179,ovl_Demo_Ext,False,2368,2736,0.865,-368,1987
180,ovl_Demo_Geff,False,2080,2800,0.743,-720,1862
181,ovl_Demo_Gj,False,15536,16192,0.959,-656,12966
182,ovl_Demo_Go,False,3424,3584,0.955,-160,2921
183,ovl_Demo_Gt,False,22016,23696,0.929,-1680,19105
184,ovl_Demo_Ik,False,5392,6368,0.847,-976,4598
185,ovl_Demo_Im,False,16240,17056,0.952,-816,13546
186,ovl_Demo_Kankyo,False,15536,16640,0.934,-1104,13085
187,ovl_Demo_Kekkai,False,4832,5264,0.918,-432,4211
188,ovl_Demo_Sa,False,11040,11728,0.941,-688,9105
189,ovl_Demo_Shd,False,9232,9360,0.986,-128,6063
190,ovl_Demo_Tre_Lgt,False,1808,2096,0.863,-288,986
191,ovl_Door_Ana,False,1648,1776,0.928,-128,1427
192,ovl_Door_Gerudo,False,1520,1648,0.922,-128,1288
193,ovl_Door_Killer,False,5488,5712,0.961,-224,4845
194,ovl_Door_Shutter,False,8832,9088,0.972,-256,7668
195,ovl_Door_Toki,False,352,352,1.0,0,212
196,ovl_Door_Warp1,False,17056,17696,0.964,-640,14650
197,ovl_Efc_Erupc,False,2784,3104,0.897,-320,2384
198,ovl_Eff_Dust,False,5088,5344,0.952,-256,4220
199,ovl_Effect_Ss_Blast,False,912,1024,0.891,-112,495
200,ovl_Effect_Ss_Bomb,False,1056,1184,0.892,-128,801
201,ovl_Effect_Ss_Bomb2,False,2352,2544,0.925,-192,1939
202,ovl_Effect_Ss_Bubble,False,1152,1296,0.889,-144,1006
203,ovl_Effect_Ss_D_Fire,False,1264,1360,0.929,-96,1068
204,ovl_Effect_Ss_Dead_Db,False,1248,1344,0.929,-96,867
205,ovl_Effect_Ss_Dead_Dd,False,1424,1584,0.899,-160,757
206,ovl_Effect_Ss_Dead_Ds,False,1152,1312,0.878,-160,789
207,ovl_Effect_Ss_Dead_Sound,False,320,384,0.833,-64,253
208,ovl_Effect_Ss_Dt_Bubble,False,1424,1568,0.908,-144,759
209,ovl_Effect_Ss_Dust,False,2096,2192,0.956,-96,1564
210,ovl_Effect_Ss_En_Fire,False,1856,2000,0.928,-144,1323
211,ovl_Effect_Ss_En_Ice,False,2064,2448,0.843,-384,1498
212,ovl_Effect_Ss_Extra,False,960,1120,0.857,-160,785
213,ovl_Effect_Ss_Fcircle,False,1200,1344,0.893,-144,865
214,ovl_Effect_Ss_Fhg_Flash,False,3968,4320,0.919,-352,2711
215,ovl_Effect_Ss_Fire_Tail,False,1792,1936,0.926,-144,1409
216,ovl_Effect_Ss_G_Fire,False,656,640,1.025,16,404
217,ovl_Effect_Ss_G_Magma,False,608,592,1.027,16,351
218,ovl_Effect_Ss_G_Magma2,False,1296,1472,0.88,-176,1100
219,ovl_Effect_Ss_G_Ripple,False,1376,1488,0.925,-112,1167
220,ovl_Effect_Ss_G_Spk,False,1456,1552,0.938,-96,982
221,ovl_Effect_Ss_G_Splash,False,1200,1200,1.0,0,553
222,ovl_Effect_Ss_Hahen,False,1600,1888,0.847,-288,1420
223,ovl_Effect_Ss_HitMark,False,1360,1456,0.934,-96,962
224,ovl_Effect_Ss_Ice_Piece,False,1088,1264,0.861,-176,685
225,ovl_Effect_Ss_Ice_Smoke,False,1216,1472,0.826,-256,1031
226,ovl_Effect_Ss_K_Fire,False,1072,1232,0.87,-160,749
227,ovl_Effect_Ss_Kakera,False,4240,4496,0.943,-256,3720
228,ovl_Effect_Ss_KiraKira,False,1648,1760,0.936,-112,1094
229,ovl_Effect_Ss_Lightning,False,1744,1856,0.94,-112,1332
230,ovl_Effect_Ss_Sibuki,False,1744,1840,0.948,-96,1211
231,ovl_Effect_Ss_Sibuki2,False,816,976,0.836,-160,641
232,ovl_Effect_Ss_Solder_Srch_Ball,False,432,416,1.038,16,220
233,ovl_Effect_Ss_Stick,False,928,1072,0.866,-144,582
234,ovl_Effect_Ss_Stone1,False,912,1056,0.864,-144,719
235,ovl_Elf_Msg,False,1520,3040,0.5,-1520,1322
236,ovl_Elf_Msg2,False,1136,2080,0.546,-944,979
237,ovl_En_Am,False,9216,9296,0.991,-80,7429
238,ovl_En_Ani,False,3440,3504,0.982,-64,2921
239,ovl_En_Anubice,False,4784,5248,0.912,-464,4243
240,ovl_En_Anubice_Fire,False,3520,3680,0.957,-160,1946
241,ovl_En_Anubice_Tag,False,720,976,0.738,-256,621
242,ovl_En_Arow_Trap,False,336,336,1.0,0,62
243,ovl_En_Arrow,False,5872,6112,0.961,-240,5014
244,ovl_En_Attack_Niw,False,4704,4688,1.003,16,3859
245,ovl_En_Ba,False,7888,8080,0.976,-192,6858
246,ovl_En_Bb,False,15568,15696,0.992,-128,13441
247,ovl_En_Bdfire,False,2960,3120,0.949,-160,2592
248,ovl_En_Bigokuta,False,11024,11328,0.973,-304,9486
249,ovl_En_Bili,False,8912,8976,0.993,-64,7434
250,ovl_En_Bird,False,1216,1200,1.013,16,1009
251,ovl_En_Blkobj,False,1376,1648,0.835,-272,1193
252,ovl_En_Bom,False,3792,3936,0.963,-144,3229
253,ovl_En_Bom_Bowl_Man,False,5440,6160,0.883,-720,4855
254,ovl_En_Bom_Bowl_Pit,False,2416,2544,0.95,-128,2075
255,ovl_En_Bom_Chu,False,5792,5936,0.976,-144,4773
256,ovl_En_Bombf,False,5232,5408,0.967,-176,4534
257,ovl_En_Boom,False,2240,2368,0.946,-128,1714
258,ovl_En_Box,False,6960,7488,0.929,-528,5483
259,ovl_En_Brob,False,4336,4336,1.0,0,2906
260,ovl_En_Bubble,False,5152,5232,0.985,-80,4239
261,ovl_En_Butte,False,5584,5744,0.972,-160,4803
262,ovl_En_Bw,False,13152,13312,0.988,-160,10420
263,ovl_En_Bx,False,2800,2992,0.936,-192,2422
264,ovl_En_Changer,False,2528,3872,0.653,-1344,2273
265,ovl_En_Clear_Tag,False,35696,36384,0.981,-688,27682
266,ovl_En_Cow,False,5216,5184,1.006,32,4178
267,ovl_En_Crow,False,5792,5744,1.008,48,4954
268,ovl_En_Cs,False,4656,4736,0.983,-80,3891
269,ovl_En_Daiku,False,5952,6128,0.971,-176,5010
270,ovl_En_Daiku_Kakariko,False,5056,5296,0.955,-240,4423
271,ovl_En_Dekubaba,False,15008,15760,0.952,-752,13293
272,ovl_En_Dekunuts,False,6144,6112,1.005,32,5148
273,ovl_En_Dh,False,6864,6976,0.984,-112,5674
274,ovl_En_Dha,False,4048,4080,0.992,-32,3427
275,ovl_En_Diving_Game,False,6576,6880,0.956,-304,5715
276,ovl_En_Dns,False,5008,5520,0.907,-512,4195
277,ovl_En_Dnt_Demo,False,3360,4608,0.729,-1248,3022
278,ovl_En_Dnt_Jiji,False,5392,6112,0.882,-720,4818
279,ovl_En_Dnt_Nomal,False,11776,12544,0.939,-768,10697
280,ovl_En_Dodojr,False,7840,7824,1.002,16,5402
281,ovl_En_Dodongo,False,11680,11648,1.003,32,9590
282,ovl_En_Dog,False,4528,4608,0.983,-80,3286
283,ovl_En_Door,False,3632,3680,0.987,-48,3039
284,ovl_En_Ds,False,3104,3072,1.01,32,2450
285,ovl_En_Du,False,6816,6848,0.995,-32,5613
286,ovl_En_Dy_Extra,False,1408,1696,0.83,-288,1273
287,ovl_En_Eg,False,432,528,0.818,-96,340
288,ovl_En_Eiyer,False,7264,7312,0.993,-48,6239
289,ovl_En_Elf,False,18880,19184,0.984,-304,14835
290,ovl_En_Encount1,False,2912,4720,0.617,-1808,2637
291,ovl_En_Encount2,False,4656,5392,0.864,-736,4061
292,ovl_En_Ex_Item,False,4464,5488,0.813,-1024,4115
293,ovl_En_Ex_Ruppy,False,4288,4784,0.896,-496,3817
294,ovl_En_Fd,False,11456,11760,0.974,-304,8888
295,ovl_En_Fd_Fire,False,3344,3504,0.954,-160,2616
296,ovl_En_Fhg_Fire,False,9760,10688,0.913,-928,8710
297,ovl_En_Fire_Rock,False,4368,5200,0.84,-832,3936
298,ovl_En_Firefly,False,8560,8720,0.982,-160,7457
299,ovl_En_Fish,False,8464,8848,0.957,-384,7181
300,ovl_En_Floormas,False,13280,13456,0.987,-176,11479
301,ovl_En_Fr,False,10896,11888,0.917,-992,9779
302,ovl_En_Fu,False,3392,3456,0.981,-64,2773
303,ovl_En_Fw,False,6064,6176,0.982,-112,4329
304,ovl_En_Fz,False,8208,8448,0.972,-240,6714
305,ovl_En_G_Switch,False,6192,7840,0.79,-1648,5618
306,ovl_En_Ganon_Mant,False,16928,17056,0.992,-128,9168
307,ovl_En_Ganon_Organ,False,28672,29056,0.987,-384,18403
308,ovl_En_Gb,False,5936,6128,0.969,-192,4998
309,ovl_En_Ge1,False,8240,8800,0.936,-560,6902
310,ovl_En_Ge2,False,6560,6736,0.974,-176,5240
311,ovl_En_Ge3,False,2896,3312,0.874,-416,2536
312,ovl_En_GeldB,False,21424,21568,0.993,-144,18581
313,ovl_En_GirlA,False,10528,12176,0.865,-1648,9064
314,ovl_En_Gm,False,3376,3728,0.906,-352,3032
315,ovl_En_Go,False,17984,18368,0.979,-384,15096
316,ovl_En_Go2,False,24608,24976,0.985,-368,20607
317,ovl_En_Goma,False,11408,11744,0.971,-336,8932
318,ovl_En_Goroiwa,False,9152,9856,0.929,-704,7899
319,ovl_En_Gs,False,7840,7936,0.988,-96,5218
320,ovl_En_Guest,False,2464,2864,0.86,-400,2235
321,ovl_En_Hata,False,1424,1408,1.011,16,942
322,ovl_En_Heishi1,False,5392,7120,0.757,-1728,4939
323,ovl_En_Heishi2,False,8704,10144,0.858,-1440,7969
324,ovl_En_Heishi3,False,2512,2704,0.929,-192,2059
325,ovl_En_Heishi4,False,3840,4400,0.873,-560,3465
326,ovl_En_Hintnuts,False,6704,6672,1.005,32,5751
327,ovl_En_Holl,False,4048,4128,0.981,-80,3402
328,ovl_En_Honotrap,False,5456,5824,0.937,-368,4285
329,ovl_En_Horse,False,49696,49760,0.999,-64,41926
330,ovl_En_Horse_Game_Check,False,4304,4368,0.985,-64,3380
331,ovl_En_Horse_Ganon,False,3456,3440,1.005,16,2847
332,ovl_En_Horse_Link_Child,False,7680,7808,0.984,-128,6262
333,ovl_En_Horse_Normal,False,9760,9856,0.99,-96,7872
334,ovl_En_Horse_Zelda,False,2800,2768,1.012,32,2328
335,ovl_En_Hs,False,2976,3072,0.969,-96,2513
336,ovl_En_Hs2,False,1504,1552,0.969,-48,1020
337,ovl_En_Hy,False,14656,14912,0.983,-256,11772
338,ovl_En_Ice_Hono,False,4592,4896,0.938,-304,4028
339,ovl_En_Ik,False,17968,19600,0.917,-1632,15447
340,ovl_En_In,False,11616,11888,0.977,-272,9455
341,ovl_En_Insect,False,9504,9792,0.971,-288,8300
342,ovl_En_Ishi,False,37200,37408,0.994,-208,5298
343,ovl_En_It,False,400,384,1.042,16,190
344,ovl_En_Jj,False,5584,5648,0.989,-64,3546
345,ovl_En_Js,False,2512,2448,1.026,64,2096
346,ovl_En_Jsjutan,False,19904,20080,0.991,-176,11994
347,ovl_En_Kakasi,False,3392,3744,0.906,-352,3047
348,ovl_En_Kakasi2,False,1824,3344,0.545,-1520,1636
349,ovl_En_Kakasi3,False,4320,4736,0.912,-416,3892
350,ovl_En_Kanban,False,12624,13232,0.954,-608,8432
351,ovl_En_Karebaba,False,6384,6752,0.945,-368,5587
352,ovl_En_Ko,False,16704,16880,0.99,-176,13591
353,ovl_En_Kusa,False,5344,5552,0.963,-208,4602
354,ovl_En_Kz,False,5392,5616,0.96,-224,4690
355,ovl_En_Light,False,3568,3728,0.957,-160,1539
356,ovl_En_Lightbox,False,1152,1136,1.014,16,758
357,ovl_En_M_Fire1,False,416,416,1.0,0,187
358,ovl_En_M_Thunder,False,5616,5808,0.967,-192,4944
359,ovl_En_Ma1,False,4832,4880,0.99,-48,3540
360,ovl_En_Ma2,False,4192,4352,0.963,-160,3504
361,ovl_En_Ma3,False,3952,4192,0.943,-240,3543
362,ovl_En_Mag,False,12048,9552,1.261,2496,8676
363,ovl_En_Mb,False,16704,16896,0.989,-192,14583
364,ovl_En_Md,False,9840,9904,0.994,-64,8171
365,ovl_En_Mk,False,3728,3696,1.009,32,3000
366,ovl_En_Mm,False,5664,5856,0.967,-192,4813
367,ovl_En_Mm2,False,3520,3792,0.928,-272,3032
368,ovl_En_Ms,False,1776,1792,0.991,-16,1374
369,ovl_En_Mu,False,2336,2416,0.967,-80,1945
370,ovl_En_Nb,False,17872,18928,0.944,-1056,15067
371,ovl_En_Niw,False,13104,14336,0.914,-1232,11903
372,ovl_En_Niw_Girl,False,2768,3264,0.848,-496,2515
373,ovl_En_Niw_Lady,False,6368,7696,0.827,-1328,5787
374,ovl_En_Nutsball,False,1568,1680,0.933,-112,1233
375,ovl_En_Nwc,False,2624,2768,0.948,-144,2215
376,ovl_En_Ny,False,6448,6896,0.935,-448,5523
377,ovl_En_OE2,False,224,192,1.167,32,131
378,ovl_En_Okarina_Effect,False,944,1472,0.641,-528,835
379,ovl_En_Okarina_Tag,False,5344,6464,0.827,-1120,4504
380,ovl_En_Okuta,False,9696,9792,0.99,-96,8436
381,ovl_En_Ossan,False,26080,29312,0.89,-3232,23570
382,ovl_En_Owl,False,15264,16048,0.951,-784,13623
383,ovl_En_Part,False,5648,5840,0.967,-192,4831
384,ovl_En_Peehat,False,14080,14352,0.981,-272,12084
385,ovl_En_Po_Desert,False,3520,3664,0.961,-144,2861
386,ovl_En_Po_Field,False,14816,15280,0.97,-464,12346
387,ovl_En_Po_Relay,False,5904,6224,0.949,-320,5224
388,ovl_En_Po_Sisters,False,19696,19904,0.99,-208,17220
389,ovl_En_Poh,False,16784,17264,0.972,-480,14853
390,ovl_En_Pu_box,False,832,832,1.0,0,404
391,ovl_En_Rd,False,10416,10448,0.997,-32,8856
392,ovl_En_Reeba,False,6768,7264,0.932,-496,5944
393,ovl_En_River_Sound,False,2448,2432,1.007,16,1832
394,ovl_En_Rl,False,3808,4496,0.847,-688,3347
395,ovl_En_Rr,False,9504,10192,0.932,-688,8187
396,ovl_En_Ru1,False,30368,31040,0.978,-672,25037
397,ovl_En_Ru2,False,11648,12304,0.947,-656,9318
398,ovl_En_Sa,False,8816,8848,0.996,-32,6679
399,ovl_En_Sb,False,5184,5248,0.988,-64,3898
400,ovl_En_Scene_Change,False,304,432,0.704,-128,252
401,ovl_En_Sda,False,5696,6208,0.918,-512,4919
402,ovl_En_Shopnuts,False,3856,3952,0.976,-96,3121
403,ovl_En_Si,False,1280,1264,1.013,16,948
404,ovl_En_Siofuki,False,3504,3616,0.969,-112,3073
405,ovl_En_Skb,False,6384,6416,0.995,-32,5440
406,ovl_En_Skj,False,14640,15344,0.954,-704,12414
407,ovl_En_Skjneedle,False,784,960,0.817,-176,669
408,ovl_En_Ssh,False,9712,9760,0.995,-48,7711
409,ovl_En_St,False,11376,11440,0.994,-64,9359
410,ovl_En_Sth,False,16560,16992,0.975,-432,13480
411,ovl_En_Stream,False,1424,1552,0.918,-128,1206
412,ovl_En_Sw,False,14192,14464,0.981,-272,12049
413,ovl_En_Syateki_Itm,False,3488,4544,0.768,-1056,2937
414,ovl_En_Syateki_Man,False,3520,4224,0.833,-704,3147
415,ovl_En_Syateki_Niw,False,8336,8624,0.967,-288,7292
416,ovl_En_Ta,False,14784,15040,0.983,-256,12814
417,ovl_En_Takara_Man,False,2240,2512,0.892,-272,2019
418,ovl_En_Tana,False,672,1072,0.627,-400,601
419,ovl_En_Tg,False,1744,1824,0.956,-80,1419
420,ovl_En_Tite,False,11680,11904,0.981,-224,10036
421,ovl_En_Tk,False,7728,8080,0.956,-352,6488
422,ovl_En_Torch,False,240,240,1.0,0,37
423,ovl_En_Torch2,False,10080,10160,0.992,-80,8233
424,ovl_En_Toryo,False,3216,3184,1.01,32,2515
425,ovl_En_Tp,False,7760,7952,0.976,-192,6713
426,ovl_En_Tr,False,6400,6512,0.983,-112,5536
427,ovl_En_Trap,False,4768,4752,1.003,16,4002
428,ovl_En_Tubo_Trap,False,3232,3520,0.918,-288,2812
429,ovl_En_Vali,False,9888,10240,0.966,-352,8436
430,ovl_En_Vase,False,256,240,1.067,16,172
431,ovl_En_Vb_Ball,False,4512,4704,0.959,-192,3579
432,ovl_En_Viewer,False,11952,12864,0.929,-912,10665
433,ovl_En_Vm,False,6320,6544,0.966,-224,5317
434,ovl_En_Wall_Tubo,False,1264,1840,0.687,-576,1100
435,ovl_En_Wallmas,False,6672,6912,0.965,-240,5761
436,ovl_En_Weather_Tag,False,3824,4720,0.81,-896,3333
437,ovl_En_Weiyer,False,6656,6688,0.995,-32,5839
438,ovl_En_Wf,False,17168,17328,0.991,-160,13527
439,ovl_En_Wonder_Item,False,3152,4016,0.785,-864,2787
440,ovl_En_Wonder_Talk,False,1680,3552,0.473,-1872,1532
441,ovl_En_Wonder_Talk2,False,1696,4256,0.398,-2560,1546
442,ovl_En_Wood02,False,4560,4704,0.969,-144,3779
443,ovl_En_Xc,False,26464,27568,0.96,-1104,22609
444,ovl_En_Yabusame_Mark,False,1744,3072,0.568,-1328,1571
445,ovl_En_Yukabyun,False,1552,1680,0.924,-128,1333
446,ovl_En_Zf,False,27376,27360,1.001,16,23354
447,ovl_En_Zl1,False,15872,15952,0.995,-80,8748
448,ovl_En_Zl2,False,18224,18976,0.96,-752,15496
449,ovl_En_Zl3,False,32336,33792,0.957,-1456,27705
450,ovl_En_Zl4,False,18992,19056,0.997,-64,13121
451,ovl_En_Zo,False,9648,10144,0.951,-496,7466
452,ovl_En_fHG,False,10544,11616,0.908,-1072,9654
453,ovl_End_Title,False,16688,17024,0.98,-336,12958
454,ovl_Fishing,False,80336,83664,0.96,-3328,71469
455,ovl_Item_B_Heart,False,1008,1184,0.851,-176,861
456,ovl_Item_Etcetera,False,2256,2544,0.887,-288,1969
457,ovl_Item_Inbox,False,352,336,1.048,16,226
458,ovl_Item_Ocarina,False,2000,2032,0.984,-32,1725
459,ovl_Item_Shield,False,2576,2736,0.942,-160,2139
460,ovl_Magic_Dark,False,6224,6560,0.949,-336,5289
461,ovl_Magic_Fire,False,8912,9104,0.979,-192,7841
462,ovl_Magic_Wind,False,7424,8016,0.926,-592,6724
463,ovl_Mir_Ray,False,6336,6704,0.945,-368,5285
464,ovl_Obj_Bean,False,10128,10720,0.945,-592,8893
465,ovl_Obj_Blockstop,False,416,400,1.04,16,292
466,ovl_Obj_Bombiwa,False,1392,1392,1.0,0,948
467,ovl_Obj_Comb,False,2144,2240,0.957,-96,1657
468,ovl_Obj_Dekujr,False,1600,1760,0.909,-160,1200
469,ovl_Obj_Elevator,False,960,1168,0.822,-208,842
470,ovl_Obj_Hamishi,False,2128,2256,0.943,-128,1263
471,ovl_Obj_Hana,False,784,768,1.021,16,586
472,ovl_Obj_Hsblock,False,1488,1792,0.83,-304,1283
473,ovl_Obj_Ice_Poly,False,2480,2624,0.945,-144,847
474,ovl_Obj_Kibako,False,3328,3376,0.986,-48,2607
475,ovl_Obj_Kibako2,False,1728,1792,0.964,-64,921
476,ovl_Obj_Lift,False,2592,2768,0.936,-176,2253
477,ovl_Obj_Lightswitch,False,5168,5840,0.885,-672,3545
478,ovl_Obj_Makekinsuta,False,336,672,0.5,-336,294
479,ovl_Obj_Makeoshihiki,False,1168,1424,0.82,-256,795
480,ovl_Obj_Mure,False,4112,5280,0.779,-1168,3620
481,ovl_Obj_Mure2,False,2592,2704,0.959,-112,2199
482,ovl_Obj_Mure3,False,2000,1968,1.016,32,1086
483,ovl_Obj_Oshihiki,False,6832,7760,0.88,-928,6097
484,ovl_Obj_Roomtimer,False,592,576,1.028,16,423
485,ovl_Obj_Switch,False,7616,8352,0.912,-736,6532
486,ovl_Obj_Syokudai,False,3120,3296,0.947,-176,2708
487,ovl_Obj_Timeblock,False,3136,3520,0.891,-384,2636
488,ovl_Obj_Tsubo,False,4080,4240,0.962,-160,3405
489,ovl_Obj_Warp2block,False,2864,3248,0.882,-384,2281
490,ovl_Object_Kankyo,False,12832,13776,0.931,-944,11392
491,ovl_Oceff_Spot,False,3888,4208,0.924,-320,3418
492,ovl_Oceff_Storm,False,7072,7344,0.963,-272,6468
493,ovl_Oceff_Wipe,False,3408,3616,0.942,-208,2783
494,ovl_Oceff_Wipe2,False,6000,6208,0.966,-208,5472
495,ovl_Oceff_Wipe3,False,5968,6176,0.966,-208,5565
496,ovl_Oceff_Wipe4,False,4064,4272,0.951,-208,3347
497,ovl_Shot_Sun,False,1728,1856,0.931,-128,1469
498,gameplay_keep,False,376032,354224,1.062,21808,244764
500,gameplay_dangeon_keep,False,97008,97008,1.0,0,7972
502,object_link_boy,False,227328,227328,1.0,0,2023
507,object_poh,False,20704,20704,1.0,0,3
517,object_kingdodongo,False,194784,199904,0.974,-5120,76638
519,object_zf,False,91040,91040,1.0,0,2
520,object_goma,False,123392,128512,0.96,-5120,11175
529,object_st,False,23472,23472,1.0,0,11
547,object_ydan_objects,False,36992,36992,1.0,0,3
569,object_menkuri_objects,False,35600,35600,1.0,0,188
582,object_fhg,False,69088,74208,0.931,-5120,38776
586,object_toki_objects,False,33872,33872,1.0,0,4
597,object_haka_objects,False,120496,120496,1.0,0,509
613,object_trap,False,9184,9184,1.0,0,4
618,object_xc,False,117536,114944,1.023,2592,105964
620,object_bv,False,122288,127408,0.96,-5120,98585
627,object_god_lgt,False,17232,17232,1.0,0,2
635,object_heavy_object,False,6880,6880,1.0,0,755
637,object_fd,False,66160,71280,0.928,-5120,5399
638,object_du,False,75312,73776,1.021,1536,53416
650,object_gi_key,False,2592,2592,1.0,0,2
651,object_mir_ray,False,7424,7424,1.0,0,612
653,object_gi_jewel,False,13952,13952,1.0,0,10
660,object_mo,False,31856,36976,0.862,-5120,21041
661,object_sb,False,11424,11424,1.0,0,4
662,object_gi_melody,False,3360,3360,1.0,0,2
663,object_gi_heart,False,496,496,1.0,0,2
664,object_gi_compass,False,3344,3344,1.0,0,4
665,object_gi_bosskey,False,4112,4112,1.0,0,4
666,object_gi_medal,False,21360,21360,1.0,0,14
667,object_gi_nuts,False,4544,4544,1.0,0,2
669,object_gi_hearts,False,6064,6064,1.0,0,10
670,object_gi_arrowcase,False,3248,3248,1.0,0,6
671,object_gi_bombpouch,False,3680,3680,1.0,0,4
678,object_gi_bottle,False,2288,2288,1.0,0,4
679,object_gi_stick,False,1728,1728,1.0,0,2
680,object_gi_map,False,4448,4448,1.0,0,4
683,object_gi_shield_1,False,3408,3408,1.0,0,4
685,object_gi_magicpot,False,4560,4560,1.0,0,4
686,object_gi_bomb_1,False,3248,3248,1.0,0,4
691,object_tw,False,236464,241584,0.979,-5120,43148
695,object_gi_gerudo,False,4928,4928,1.0,0,1013
696,object_gi_arrow,False,6928,6928,1.0,0,12
697,object_gi_bomb_2,False,1696,1696,1.0,0,2
698,object_gi_egg,False,4896,4896,1.0,0,4
699,object_gi_scale,False,3568,3568,1.0,0,6
700,object_gi_shield_2,False,4208,4208,1.0,0,4
701,object_gi_hookshot,False,5472,5472,1.0,0,8
702,object_gi_ocarina,False,2992,2992,1.0,0,2
703,object_gi_milk,False,5232,5232,1.0,0,6
705,object_ganon,False,65792,70912,0.928,-5120,6996
706,object_sst,False,104368,109488,0.953,-5120,17536
707,object_ny,False,8560,8560,1.0,0,4
709,object_gi_pachinko,False,3168,3168,1.0,0,4
710,object_gi_boomerang,False,3488,3488,1.0,0,4
711,object_gi_bow,False,3376,3376,1.0,0,6
712,object_gi_glasses,False,4480,4480,1.0,0,4
713,object_gi_liquid,False,6352,6352,1.0,0,8
715,object_demo_6k,False,15264,15264,1.0,0,2
716,object_gi_shield_3,False,4800,4800,1.0,0,578
719,object_jya_obj,False,115008,115008,1.0,0,1138
721,object_gi_bean,False,2240,2240,1.0,0,4
722,object_gi_fish,False,2384,2384,1.0,0,6
723,object_gi_saw,False,2944,2944,1.0,0,4
724,object_gi_hammer,False,3264,3264,1.0,0,4
725,object_gi_grass,False,3088,3088,1.0,0,4
726,object_gi_longsword,False,2240,2240,1.0,0,4
731,object_zo,False,49216,49216,1.0,0,4
742,object_gi_niwatori,False,6640,6640,1.0,0,2
744,object_gi_bottle_letter,False,3200,3200,1.0,0,6
747,object_gi_ocarina_0,False,3088,3088,1.0,0,2
753,object_fz,False,13520,13520,1.0,0,13
757,object_gi_boots_2,False,7104,7104,1.0,0,4
758,object_gi_seed,False,2752,2752,1.0,0,2
767,object_nwc,False,3488,3488,1.0,0,2
774,object_kusa,False,896,896,1.0,0,4
776,object_gi_gloves,False,6496,6496,1.0,0,4
777,object_gi_coin,False,2128,2128,1.0,0,4
778,object_kanban,False,6064,6064,1.0,0,54
783,object_gi_ki_tan_mask,False,3568,3568,1.0,0,2
784,object_gi_redead_mask,False,2704,2704,1.0,0,2
785,object_gi_skj_mask,False,3296,3296,1.0,0,2
786,object_gi_rabit_mask,False,3840,3840,1.0,0,2
787,object_gi_truth_mask,False,6240,6240,1.0,0,4
789,object_siofuki,False,3504,3504,1.0,0,2
790,object_stream,False,2688,2688,1.0,0,2
794,object_gi_eye_lotion,False,2416,2416,1.0,0,4
795,object_gi_powder,False,2944,2944,1.0,0,4
796,object_gi_mushroom,False,3280,3280,1.0,0,4
797,object_gi_ticketstone,False,4768,4768,1.0,0,2
798,object_gi_brokensword,False,2448,2448,1.0,0,4
801,object_gi_prescription,False,3104,3104,1.0,0,2
802,object_gi_bracelet,False,3056,3056,1.0,0,2
804,object_gi_frog,False,4368,4368,1.0,0,2
805,object_mag,False,128064,153920,0.832,-25856,63707
808,object_efc_erupc,False,10480,10480,1.0,0,2
814,object_ganon2,False,215024,220144,0.977,-5120,70100
818,object_gi_hoverboots,False,7792,7792,1.0,0,4
819,object_gi_m_arrow,False,3712,3712,1.0,0,6
822,object_fish,False,87536,87536,1.0,0,7
823,object_gi_sutaru,False,1616,1616,1.0,0,11
824,object_gi_goddess,False,3152,3152,1.0,0,6
846,object_gi_fire,False,4064,4064,1.0,0,2
847,object_gi_insect,False,3056,3056,1.0,0,4
848,object_gi_butterfly,False,3024,3024,1.0,0,4
849,object_gi_ghost,False,3504,3504,1.0,0,6
850,object_gi_soul,False,4016,4016,1.0,0,6
852,object_po_field,False,27200,27200,1.0,0,3
853,object_demo_kekkai,False,60688,60688,1.0,0,4
855,object_gi_dekupouch,False,4176,4176,1.0,0,6
859,object_gi_rupy,False,2048,2048,1.0,0,4
862,object_po_composer,False,28576,28576,1.0,0,3
870,object_ps,False,51456,51456,1.0,0,3
875,object_gi_sword_1,False,3360,3360,1.0,0,6
880,g_pn_01,False,6912,10368,0.667,-3456,3966
881,g_pn_02,False,6912,10368,0.667,-3456,4176
882,g_pn_03,False,6912,10368,0.667,-3456,3461
883,g_pn_04,False,6912,10368,0.667,-3456,3728
884,g_pn_05,False,6912,10368,0.667,-3456,3894
885,g_pn_06,False,6912,10368,0.667,-3456,4533
886,g_pn_07,False,6912,10368,0.667,-3456,4836
887,g_pn_08,False,6912,10368,0.667,-3456,4570
888,g_pn_09,False,6912,10368,0.667,-3456,4728
889,g_pn_10,False,6912,10368,0.667,-3456,3185
890,g_pn_11,False,6912,10368,0.667,-3456,4788
891,g_pn_12,False,6912,10368,0.667,-3456,4617
892,g_pn_13,False,6912,10368,0.667,-3456,4695
893,g_pn_14,False,6912,10368,0.667,-3456,4669
894,g_pn_15,False,6912,10368,0.667,-3456,4691
895,g_pn_16,False,6912,10368,0.667,-3456,4481
896,g_pn_17,False,6912,10368,0.667,-3456,2659
897,g_pn_18,False,6912,10368,0.667,-3456,3407
898,g_pn_19,False,6912,10368,0.667,-3456,3562
899,g_pn_20,False,6912,10368,0.667,-3456,3748
900,g_pn_21,False,6912,10368,0.667,-3456,3323
901,g_pn_22,False,6912,10368,0.667,-3456,4413
902,g_pn_23,False,6912,10368,0.667,-3456,2278
903,g_pn_24,False,6912,10368,0.667,-3456,3543
904,g_pn_25,False,6912,10368,0.667,-3456,4530
905,g_pn_26,False,6912,10368,0.667,-3456,4599
906,g_pn_27,False,6912,10368,0.667,-3456,4183
907,g_pn_28,False,6912,10368,0.667,-3456,4481
908,g_pn_29,False,6912,10368,0.667,-3456,2985
909,g_pn_30,False,6912,10368,0.667,-3456,3323
910,g_pn_31,False,6912,10368,0.667,-3456,3616
911,g_pn_32,False,6912,10368,0.667,-3456,3298
912,g_pn_33,False,6912,10368,0.667,-3456,4061
913,g_pn_34,False,6912,10368,0.667,-3456,4171
914,g_pn_35,False,6912,10368,0.667,-3456,3975
915,g_pn_36,False,6912,10368,0.667,-3456,3979
916,g_pn_37,False,6912,10368,0.667,-3456,4508
917,g_pn_38,False,6912,10368,0.667,-3456,3807
918,g_pn_39,False,6912,10368,0.667,-3456,4665
919,g_pn_40,False,6912,10368,0.667,-3456,4593
920,g_pn_41,False,6912,10368,0.667,-3456,3076
921,g_pn_42,False,6912,10368,0.667,-3456,4001
922,g_pn_43,False,6912,10368,0.667,-3456,4178
923,g_pn_44,False,6912,10368,0.667,-3456,4797
924,g_pn_45,False,6912,10368,0.667,-3456,4197
925,g_pn_46,False,6912,10368,0.667,-3456,3505
926,g_pn_47,False,6912,10368,0.667,-3456,4685
927,g_pn_48,False,6912,10368,0.667,-3456,2203
928,g_pn_49,False,6912,10368,0.667,-3456,4229
929,g_pn_50,False,6912,10368,0.667,-3456,4744
930,g_pn_51,False,6912,10368,0.667,-3456,4496
931,g_pn_52,False,6912,10368,0.667,-3456,4667
932,g_pn_53,False,6912,10368,0.667,-3456,4285
933,g_pn_54,False,6912,10368,0.667,-3456,4748
934,g_pn_55,False,6912,10368,0.667,-3456,4650
935,g_pn_56,False,6912,10368,0.667,-3456,4423
936,g_pn_57,False,6912,10368,0.667,-3456,242
938,nintendo_rogo_static,False,11856,11712,1.012,144,3127
939,title_static,False,234944,291904,0.805,-56960,214376
1013,spot00_scene,False,172576,172576,1.0,0,78
1015,spot01_scene,False,115024,115024,1.0,0,45
1016,spot01_room_0,False,40736,40672,1.002,64,22470
1017,spot02_scene,False,48256,48256,1.0,0,12523
1018,spot02_room_0,False,9824,9952,0.987,-128,5877
1019,spot02_room_1,False,122464,122768,0.998,-304,102992
1020,spot03_scene,False,46432,46432,1.0,0,16
1023,spot04_scene,False,70208,70208,1.0,0,195
1024,spot04_room_0,False,111488,111760,0.998,-272,87780
1025,spot04_room_1,False,34144,34176,0.999,-32,24019
1026,spot04_room_2,False,20496,20592,0.995,-96,15015
1027,spot05_scene,False,85344,85344,1.0,0,16
1029,spot06_scene,False,111664,111664,1.0,0,16
1030,spot06_room_0,False,42528,42528,1.0,0,4
1031,spot07_scene,False,38944,38944,1.0,0,24
1034,spot08_scene,False,71328,71328,1.0,0,30
1035,spot08_room_0,False,33104,33120,1.0,-16,18512
1036,spot09_scene,False,69984,69984,1.0,0,25
1037,spot09_room_0,False,34256,34752,0.986,-496,26927
1038,spot10_scene,False,66608,66608,1.0,0,120
1049,spot11_scene,False,103648,103648,1.0,0,16
1051,spot12_scene,False,65152,65152,1.0,0,1187
1054,spot13_scene,False,24112,24112,1.0,0,8
1057,spot15_scene,False,99584,99584,1.0,0,8
1059,spot16_scene,False,125584,125584,1.0,0,42
1060,spot16_room_0,False,44176,44304,0.997,-128,32001
1061,spot17_scene,False,65248,65248,1.0,0,808
1063,spot17_room_1,False,74576,74592,1.0,-16,48542
1064,spot18_scene,False,42064,42064,1.0,0,64
1069,ydan_scene,False,55824,55840,1.0,-16,48306
1070,ydan_room_0,False,86768,86864,0.999,-96,66501
1071,ydan_room_1,False,16720,16896,0.99,-176,12910
1072,ydan_room_2,False,24112,24368,0.989,-256,20833
1073,ydan_room_3,False,82336,82352,1.0,-16,60604
1074,ydan_room_4,False,19408,19504,0.995,-96,14334
1075,ydan_room_5,False,33568,33680,0.997,-112,26567
1076,ydan_room_6,False,20160,20224,0.997,-64,16546
1077,ydan_room_7,False,35088,35488,0.989,-400,31251
1078,ydan_room_8,False,3328,3472,0.959,-144,2461
1079,ydan_room_9,False,39072,39072,1.0,0,155
1080,ydan_room_10,False,19840,19968,0.994,-128,16438
1081,ydan_room_11,False,29040,29040,1.0,0,4
1082,ddan_scene,False,86336,86336,1.0,0,65014
1083,ddan_room_0,False,112800,112800,1.0,0,284
1084,ddan_room_1,False,39680,39792,0.997,-112,30545
1085,ddan_room_2,False,32160,32448,0.991,-288,25279
1086,ddan_room_3,False,56768,56944,0.997,-176,42042
1087,ddan_room_4,False,38992,39264,0.993,-272,28567
1088,ddan_room_5,False,24288,24256,1.001,32,17369
1089,ddan_room_6,False,9216,9392,0.981,-176,7684
1090,ddan_room_7,False,30416,30464,0.998,-48,22208
1091,ddan_room_8,False,37888,38304,0.989,-416,31333
1092,ddan_room_9,False,46416,46384,1.001,32,32356
1093,ddan_room_10,False,32336,32528,0.994,-192,26356
1094,ddan_room_11,False,8320,8240,1.01,80,6374
1095,ddan_room_12,False,34608,34688,0.998,-80,25880
1096,ddan_room_13,False,9344,9424,0.992,-80,7446
1097,ddan_room_14,False,9360,9424,0.993,-64,7376
1098,ddan_room_15,False,10320,10544,0.979,-224,8715
1099,ddan_room_16,False,21840,21856,0.999,-16,16947
1100,bdan_scene,False,88000,88032,1.0,-32,57756
1101,bdan_room_0,False,16496,16704,0.988,-208,12100
1102,bdan_room_1,False,24208,24512,0.988,-304,17611
1103,bdan_room_2,False,37328,37440,0.997,-112,26381
1104,bdan_room_3,False,29024,29280,0.991,-256,22996
1105,bdan_room_4,False,16464,16640,0.989,-176,12434
1106,bdan_room_5,False,24608,24720,0.995,-112,18514
1107,bdan_room_6,False,16960,16960,1.0,0,146
1108,bdan_room_7,False,13600,13520,1.006,80,8543
1109,bdan_room_8,False,14464,14400,1.004,64,8916
1110,bdan_room_9,False,15472,15408,1.004,64,9995
1111,bdan_room_10,False,14384,14368,1.001,16,7901
1112,bdan_room_11,False,14336,14832,0.967,-496,10701
1113,bdan_room_12,False,15568,15584,0.999,-16,9013
1114,bdan_room_13,False,11088,11136,0.996,-48,8632
1115,bdan_room_14,False,25056,25040,1.001,16,16257
1116,bdan_room_15,False,9952,9952,1.0,0,30
1117,Bmori1_scene,False,90000,90000,1.0,0,130
1118,Bmori1_room_0,False,56256,56208,1.001,48,42219
1119,Bmori1_room_1,False,23392,23408,0.999,-16,15203
1120,Bmori1_room_2,False,64048,63872,1.003,176,46605
1121,Bmori1_room_3,False,14864,14816,1.003,48,9669
1122,Bmori1_room_4,False,12976,12992,0.999,-16,8308
1123,Bmori1_room_5,False,13792,13776,1.001,16,8465
1124,Bmori1_room_6,False,38080,37936,1.004,144,27314
1125,Bmori1_room_7,False,77824,77792,1.0,32,52672
1126,Bmori1_room_8,False,97136,96944,1.002,192,66568
1127,Bmori1_room_9,False,41360,41312,1.001,48,26319
1128,Bmori1_room_10,False,21472,21472,1.0,0,76
1129,Bmori1_room_11,False,43984,44000,1.0,-16,24796
1130,Bmori1_room_12,False,33760,33760,1.0,0,113
1131,Bmori1_room_13,False,35504,35504,1.0,0,153
1132,Bmori1_room_14,False,23472,23408,1.003,64,15253
1133,Bmori1_room_15,False,9872,9952,0.992,-80,7786
1134,Bmori1_room_16,False,20384,20384,1.0,0,19
1135,Bmori1_room_17,False,37200,37104,1.003,96,25354
1136,Bmori1_room_18,False,4928,4912,1.003,16,3324
1137,Bmori1_room_19,False,1296,1280,1.012,16,655
1138,Bmori1_room_20,False,4864,4864,1.0,0,22
1139,Bmori1_room_21,False,6016,6000,1.003,16,3951
1140,Bmori1_room_22,False,7648,7648,1.0,0,20
1141,HIDAN_scene,False,108912,108496,1.004,416,76606
1142,HIDAN_room_0,False,29376,29424,0.998,-48,19436
1143,HIDAN_room_1,False,51680,51504,1.003,176,37420
1144,HIDAN_room_2,False,65488,65584,0.999,-96,47364
1145,HIDAN_room_3,False,9440,9424,1.002,16,5839
1146,HIDAN_room_4,False,30864,30960,0.997,-96,20623
1147,HIDAN_room_5,False,41520,41696,0.996,-176,27844
1148,HIDAN_room_6,False,28576,28560,1.001,16,19459
1149,HIDAN_room_7,False,14816,14928,0.992,-112,11168
1150,HIDAN_room_8,False,39616,39648,0.999,-32,28656
1151,HIDAN_room_9,False,34672,34672,1.0,0,94
1152,HIDAN_room_10,False,99488,99360,1.001,128,64395
1153,HIDAN_room_11,False,14272,14304,0.998,-32,9600
1154,HIDAN_room_12,False,11136,11120,1.001,16,6997
1155,HIDAN_room_13,False,52192,52112,1.002,80,32690
1156,HIDAN_room_14,False,8800,8704,1.011,96,5948
1157,HIDAN_room_15,False,4560,4496,1.014,64,2863
1158,HIDAN_room_16,False,47472,47584,0.998,-112,35089
1159,HIDAN_room_17,False,37184,37232,0.999,-48,26454
1160,HIDAN_room_18,False,15232,15360,0.992,-128,10210
1161,HIDAN_room_19,False,16864,16944,0.995,-80,10584
1162,HIDAN_room_20,False,27920,27920,1.0,0,100
1163,HIDAN_room_21,False,33984,33920,1.002,64,22638
1164,HIDAN_room_22,False,27392,27376,1.001,16,20603
1165,HIDAN_room_23,False,27936,27936,1.0,0,66
1166,HIDAN_room_24,False,21824,21824,1.0,0,156
1167,HIDAN_room_25,False,27360,27360,1.0,0,81
1168,HIDAN_room_26,False,26784,26784,1.0,0,91
1169,MIZUsin_scene,False,89328,89136,1.002,192,58444
1170,MIZUsin_room_0,False,89216,89136,1.001,80,63846
1171,MIZUsin_room_1,False,41312,41424,0.997,-112,29572
1172,MIZUsin_room_2,False,23440,23696,0.989,-256,17217
1173,MIZUsin_room_3,False,26384,26560,0.993,-176,20163
1174,MIZUsin_room_4,False,24544,24608,0.997,-64,16343
1175,MIZUsin_room_5,False,42480,42560,0.998,-80,32624
1176,MIZUsin_room_6,False,45760,45824,0.999,-64,32147
1177,MIZUsin_room_7,False,21840,21856,0.999,-16,15950
1178,MIZUsin_room_8,False,56528,56704,0.997,-176,45392
1179,MIZUsin_room_9,False,32736,32944,0.994,-208,26121
1180,MIZUsin_room_10,False,24496,24688,0.992,-192,17592
1181,MIZUsin_room_11,False,18864,18976,0.994,-112,13929
1182,MIZUsin_room_12,False,28048,28208,0.994,-160,20038
1184,MIZUsin_room_14,False,28256,28288,0.999,-32,20465
1185,MIZUsin_room_15,False,29744,29808,0.998,-64,20627
1186,MIZUsin_room_16,False,15056,15152,0.994,-96,12062
1187,MIZUsin_room_17,False,35360,35504,0.996,-144,24985
1188,MIZUsin_room_18,False,16576,16640,0.996,-64,11458
1189,MIZUsin_room_19,False,14640,14640,1.0,0,65
1190,MIZUsin_room_20,False,26432,26688,0.99,-256,20767
1191,MIZUsin_room_21,False,29856,29856,1.0,0,270
1192,MIZUsin_room_22,False,37104,37104,1.0,0,8
1193,jyasinzou_scene,False,105280,105248,1.0,32,93581
1194,jyasinzou_room_0,False,69440,69616,0.997,-176,51331
1195,jyasinzou_room_1,False,37632,37712,0.998,-80,27967
1196,jyasinzou_room_2,False,23568,23472,1.004,96,15440
1197,jyasinzou_room_3,False,15184,15312,0.992,-128,11625
1198,jyasinzou_room_4,False,29296,29312,0.999,-16,21373
1199,jyasinzou_room_5,False,98112,98320,0.998,-208,76298
1200,jyasinzou_room_6,False,18432,18416,1.001,16,12136
1201,jyasinzou_room_7,False,21776,21776,1.0,0,1070
1202,jyasinzou_room_8,False,32880,32944,0.998,-64,22344
1203,jyasinzou_room_9,False,24048,24016,1.001,32,14881
1204,jyasinzou_room_10,False,33184,33184,1.0,0,4257
1205,jyasinzou_room_11,False,4112,4112,1.0,0,810
1206,jyasinzou_room_12,False,8288,8416,0.985,-128,6512
1207,jyasinzou_room_13,False,22608,22704,0.996,-96,17607
1208,jyasinzou_room_14,False,19600,19616,0.999,-16,13685
1209,jyasinzou_room_15,False,33904,33952,0.999,-48,23182
1210,jyasinzou_room_16,False,24976,25024,0.998,-48,17030
1211,jyasinzou_room_17,False,38416,38480,0.998,-64,24746
1212,jyasinzou_room_18,False,23728,23776,0.998,-48,16393
1213,jyasinzou_room_19,False,24032,24016,1.001,16,14541
1214,jyasinzou_room_20,False,33216,33216,1.0,0,4255
1215,jyasinzou_room_21,False,18000,18016,0.999,-16,11690
1216,jyasinzou_room_22,False,12496,12400,1.008,96,9532
1217,jyasinzou_room_23,False,37264,37392,0.997,-128,25393
1218,jyasinzou_room_24,False,25776,25808,0.999,-32,16411
1219,jyasinzou_room_25,False,88944,88992,0.999,-48,65560
1220,jyasinzou_room_26,False,52000,51968,1.001,32,32705
1221,jyasinzou_room_27,False,22208,22288,0.996,-80,14397
1222,jyasinzou_room_28,False,35360,35376,1.0,-16,23908
1223,HAKAdan_scene,False,99264,99264,1.0,0,140
1224,HAKAdan_room_0,False,45248,45392,0.997,-144,29422
1225,HAKAdan_room_1,False,6848,6896,0.993,-48,4602
1226,HAKAdan_room_2,False,43280,43488,0.995,-208,32258
1227,HAKAdan_room_3,False,10560,10624,0.994,-64,7533
1228,HAKAdan_room_4,False,7232,7264,0.996,-32,5003
1229,HAKAdan_room_5,False,23136,23232,0.996,-96,16206
1230,HAKAdan_room_6,False,30064,30192,0.996,-128,19305
1231,HAKAdan_room_7,False,6832,6880,0.993,-48,4647
1232,HAKAdan_room_8,False,20576,20640,0.997,-64,12000
1233,HAKAdan_room_9,False,52064,52368,0.994,-304,39202
1234,HAKAdan_room_10,False,30624,30704,0.997,-80,22827
1235,HAKAdan_room_11,False,15680,15968,0.982,-288,12966
1236,HAKAdan_room_12,False,22304,22352,0.998,-48,15483
1237,HAKAdan_room_13,False,4016,4128,0.973,-112,3257
1238,HAKAdan_room_14,False,22848,22784,1.003,64,15114
1239,HAKAdan_room_15,False,29296,29376,0.997,-80,17979
1240,HAKAdan_room_16,False,10368,10544,0.983,-176,7704
1241,HAKAdan_room_17,False,11472,11744,0.977,-272,9660
1242,HAKAdan_room_18,False,53888,54032,0.997,-144,35532
1243,HAKAdan_room_19,False,11552,11648,0.992,-96,9211
1244,HAKAdan_room_20,False,7712,7744,0.996,-32,5178
1245,HAKAdan_room_21,False,46256,46512,0.994,-256,35200
1246,HAKAdan_room_22,False,10656,10672,0.999,-16,8193
1247,HAKAdanCH_scene,False,50528,50576,0.999,-48,31941
1248,HAKAdanCH_room_0,False,87536,87840,0.997,-304,67524
1249,HAKAdanCH_room_1,False,45776,45360,1.009,416,33876
1250,HAKAdanCH_room_2,False,12688,12640,1.004,48,7162
1251,HAKAdanCH_room_3,False,7264,7360,0.987,-96,4738
1252,HAKAdanCH_room_4,False,9296,9376,0.991,-80,7111
1253,HAKAdanCH_room_5,False,10592,10640,0.995,-48,8152
1254,HAKAdanCH_room_6,False,11904,11936,0.997,-32,9780
1255,ice_doukutu_scene,False,71184,71360,0.998,-176,65159
1256,ice_doukutu_room_0,False,34400,34432,0.999,-32,28036
1257,ice_doukutu_room_1,False,50496,50480,1.0,16,39359
1258,ice_doukutu_room_2,False,23280,23296,0.999,-16,18593
1259,ice_doukutu_room_3,False,32896,32912,1.0,-16,24809
1260,ice_doukutu_room_4,False,30320,30288,1.001,32,22462
1261,ice_doukutu_room_5,False,34960,34944,1.0,16,25642
1262,ice_doukutu_room_6,False,16992,16816,1.01,176,13442
1263,ice_doukutu_room_7,False,22768,22768,1.0,0,42
1264,ice_doukutu_room_8,False,6480,6432,1.007,48,4006
1265,ice_doukutu_room_9,False,34384,34448,0.998,-64,23509
1266,ice_doukutu_room_10,False,17376,17376,1.0,0,23
1267,ice_doukutu_room_11,False,22784,22608,1.008,176,17973
1268,men_scene,False,70960,70848,1.002,112,49207
1269,men_room_0,False,65424,65424,1.0,0,12610
1270,men_room_1,False,37520,37488,1.001,32,28139
1271,men_room_2,False,20352,20560,0.99,-208,15818
1272,men_room_3,False,31776,31824,0.998,-48,24462
1273,men_room_4,False,41296,41440,0.997,-144,33034
1274,men_room_5,False,20704,20512,1.009,192,17082
1275,men_room_6,False,32576,32640,0.998,-64,23472
1276,men_room_7,False,33584,33472,1.003,112,26989
1277,men_room_8,False,33296,33328,0.999,-32,20186
1278,men_room_9,False,14576,14448,1.009,128,10985
1279,men_room_10,False,23648,23632,1.001,16,17990
1280,ganontika_scene,False,137152,137168,1.0,-16,72977
1281,ganontika_room_0,False,37312,37392,0.998,-80,21558
1282,ganontika_room_1,False,117168,117200,1.0,-32,79726
1283,ganontika_room_2,False,30688,30688,1.0,0,383
1284,ganontika_room_3,False,39312,39488,0.996,-176,31520
1285,ganontika_room_4,False,31888,31888,1.0,0,40
1286,ganontika_room_5,False,30016,29984,1.001,32,21008
1287,ganontika_room_6,False,64496,64608,0.998,-112,44483
1288,ganontika_room_7,False,31888,31888,1.0,0,43
1289,ganontika_room_8,False,36976,36896,1.002,80,26182
1290,ganontika_room_9,False,47248,47136,1.002,112,29446
1291,ganontika_room_10,False,27504,27584,0.997,-80,18522
1292,ganontika_room_11,False,26960,26960,1.0,0,114
1293,ganontika_room_12,False,45936,45680,1.006,256,32447
1294,ganontika_room_13,False,32064,32064,1.0,0,41
1295,ganontika_room_14,False,41376,41424,0.999,-48,28132
1296,ganontika_room_15,False,32064,32064,1.0,0,42
1297,ganontika_room_16,False,11808,11824,0.999,-16,7816
1298,ganontika_room_17,False,34464,34336,1.004,128,18689
1299,ganontika_room_18,False,50800,50912,0.998,-112,33537
1300,ganontika_room_19,False,32064,32064,1.0,0,38
1301,market_day_scene,False,9840,9840,1.0,0,4
1303,market_night_scene,False,9776,9776,1.0,0,4
1311,kenjyanoma_scene,False,14576,14576,1.0,0,16
1313,tokinoma_scene,False,75680,75680,1.0,0,96
1318,link_home_scene,False,7008,7008,1.0,0,12
1320,kokiri_shop_scene,False,2432,2432,1.0,0,4
1322,kokiri_home_scene,False,3264,3264,1.0,0,4
1324,kakusiana_scene,False,55328,55328,1.0,0,56
1339,entra_scene,False,992,992,1.0,0,4
1341,moribossroom_scene,False,6400,6400,1.0,0,8
1344,syatekijyou_scene,False,49856,49856,1.0,0,16
1346,shop1_scene,False,752,752,1.0,0,4
1348,hairal_niwa_scene,False,70544,70544,1.0,0,8
1350,ganon_tou_scene,False,19312,19312,1.0,0,12
1354,market_alley_scene,False,4688,4688,1.0,0,4
1356,spot20_scene,False,73152,73248,0.999,-96,52364
1357,spot20_room_0,False,26320,26320,1.0,0,58
1358,market_ruins_scene,False,5680,5680,1.0,0,4
1360,entra_n_scene,False,1072,1072,1.0,0,4
1362,enrui_scene,False,992,992,1.0,0,4
1364,market_alley_n_scene,False,4848,4848,1.0,0,4
1366,hiral_demo_scene,False,15696,15696,1.0,0,52
1368,kokiri_home3_scene,False,6048,6048,1.0,0,4
1370,malon_stable_scene,False,1648,1648,1.0,0,4
1372,kakariko_scene,False,3744,3744,1.0,0,4
1374,bdan_boss_scene,False,3648,3648,1.0,0,8
1376,bdan_boss_room_1,False,20672,20672,1.0,0,24
1377,FIRE_bs_scene,False,19456,19456,1.0,0,8
1380,hut_scene,False,1296,1296,1.0,0,4
1382,daiyousei_izumi_scene,False,57344,57344,1.0,0,20
1384,hakaana_scene,False,2704,2704,1.0,0,4
1386,yousei_izumi_tate_scene,False,34832,34832,1.0,0,160
1387,yousei_izumi_tate_room_0,False,17104,17104,1.0,0,17
1388,yousei_izumi_yoko_scene,False,52640,52640,1.0,0,16
1390,golon_scene,False,928,928,1.0,0,4
1392,zoora_scene,False,912,912,1.0,0,4
1394,drag_scene,False,1008,1008,1.0,0,4
1396,alley_shop_scene,False,1456,1456,1.0,0,5
1398,night_shop_scene,False,1648,1648,1.0,0,6
1400,impa_scene,False,3344,3344,1.0,0,6
1402,labo_scene,False,3824,3824,1.0,0,6
1404,tent_scene,False,1664,1664,1.0,0,6
1406,nakaniwa_scene,False,14880,14880,1.0,0,24
1408,ddan_boss_scene,False,10336,10336,1.0,0,14
1409,ddan_boss_room_0,False,20016,20016,1.0,0,13
1410,ddan_boss_room_1,False,15824,15840,0.999,-16,11046
1411,ydan_boss_scene,False,5952,5952,1.0,0,12
1414,HAKAdan_bs_scene,False,10112,10112,1.0,0,12
1417,MIZUsin_bs_scene,False,6752,6752,1.0,0,12
1420,ganon_scene,False,67504,67504,1.0,0,60
1431,ganon_boss_scene,False,31776,31776,1.0,0,6
1433,jyasinboss_scene,False,36080,36080,1.0,0,96
1435,jyasinboss_room_1,False,32320,32320,1.0,0,1416
1437,jyasinboss_room_3,False,46848,46848,1.0,0,1416
1438,kokiri_home4_scene,False,6832,6832,1.0,0,6
1440,kokiri_home5_scene,False,5136,5136,1.0,0,6
1442,ganon_final_scene,False,74112,74112,1.0,0,5
1444,kakariko3_scene,False,2112,2112,1.0,0,4
1448,hakasitarelay_scene,False,57968,57968,1.0,0,28
1456,shrine_scene,False,5344,5344,1.0,0,4
1458,turibori_scene,False,75488,75488,1.0,0,4
1460,shrine_n_scene,False,5376,5376,1.0,0,4
1462,shrine_r_scene,False,5264,5264,1.0,0,4
1464,hakaana2_scene,False,53392,53392,1.0,0,4
1466,gerudoway_scene,False,55584,55584,1.0,0,24
1473,hairal_niwa_n_scene,False,37104,37104,1.0,0,4
1475,bowling_scene,False,60192,60192,1.0,0,4
1477,hakaana_ouke_scene,False,19168,19168,1.0,0,36
1481,hylia_labo_scene,False,69776,69776,1.0,0,4
1483,souko_scene,False,27664,27664,1.0,0,12
1487,miharigoya_scene,False,50512,50512,1.0,0,8
1489,mahouya_scene,False,43552,43552,1.0,0,4
1491,takaraya_scene,False,29104,29104,1.0,0,28
1499,ganon_sonogo_scene,False,32528,32528,1.0,0,20
1505,ganon_demo_scene,False,36976,36976,1.0,0,8
1509,face_shop_scene,False,880,880,1.0,0,4
1511,kinsuta_scene,False,5648,5648,1.0,0,4
1513,ganontikasonogo_scene,False,19200,19200,1.0,0,8
