File,Are equals,Size in baserom,Size in other_baserom,Size proportion,Size difference
makerom,False,4192,4192,1.0,0
boot,False,24848,73488,0.338,-48640
dmadata,False,24416,24768,0.986,-352
Audiobank,True,179648,179648,1.0,0
Audioseq,True,326272,326272,1.0,0
Audiotable,True,4526992,4526992,1.0,0
link_animetion,True,2513968,2513968,1.0,0
icon_item_static,True,564384,564384,1.0,0
icon_item_24_static,True,46080,46080,1.0,0
icon_item_field_static,True,47408,47408,1.0,0
icon_item_dungeon_static,True,7552,7552,1.0,0
icon_item_gameover_static,True,15488,15488,1.0,0
icon_item_nes_static,True,56448,56448,1.0,0
icon_item_ger_static,True,60288,60288,1.0,0
icon_item_fra_static,True,62592,62592,1.0,0
item_name_static,True,377856,377856,1.0,0
map_name_static,True,205824,205824,1.0,0
do_action_static,True,33408,33408,1.0,0
message_static,True,16768,16768,1.0,0
message_texture_static,True,4608,4608,1.0,0
nes_font_static,False,17920,17920,1.0,0
nes_message_data_static,False,229504,229664,0.999,-160
ger_message_data_static,True,244176,244176,1.0,0
fra_message_data_static,True,225728,225728,1.0,0
staff_message_data_static,True,3920,3920,1.0,0
map_grand_static,True,58192,58192,1.0,0
map_i_static,True,975120,975120,1.0,0
map_48x85_static,True,138720,138720,1.0,0
code,False,1057328,1290032,0.82,-232704
ovl_title,False,2128,2960,0.719,-832
ovl_select,False,11392,12384,0.92,-992
ovl_opening,False,352,336,1.048,16
ovl_file_choose,False,60432,64192,0.941,-3760
ovl_kaleido_scope,False,117184,125312,0.935,-8128
ovl_player_actor,False,157456,157840,0.998,-384
ovl_map_mark_data,False,27360,27360,1.0,0
ovl_En_Test,False,22704,22704,1.0,0
ovl_Arms_Hook,False,3440,3600,0.956,-160
ovl_Arrow_Fire,False,7904,8128,0.972,-224
ovl_Arrow_Ice,False,7936,8160,0.973,-224
ovl_Arrow_Light,False,7952,8176,0.973,-224
ovl_Bg_Bdan_Objects,False,4816,4976,0.968,-160
ovl_Bg_Bdan_Switch,False,5168,5440,0.95,-272
ovl_Bg_Bom_Guard,False,544,640,0.85,-96
ovl_Bg_Bombwall,False,2240,2448,0.915,-208
ovl_Bg_Bowl_Wall,False,2432,2688,0.905,-256
ovl_Bg_Breakwall,False,3696,3792,0.975,-96
ovl_Bg_Ddan_Jd,False,1616,1600,1.01,16
ovl_Bg_Ddan_Kd,False,2288,2320,0.986,-32
ovl_Bg_Dodoago,False,3392,3520,0.964,-128
ovl_Bg_Dy_Yoseizo,False,11760,12528,0.939,-768
ovl_Bg_Ganon_Otyuka,False,9792,10304,0.95,-512
ovl_Bg_Gate_Shutter,False,1168,1376,0.849,-208
ovl_Bg_Gjyo_Bridge,False,1264,1392,0.908,-128
ovl_Bg_Gnd_Darkmeiro,False,1984,2192,0.905,-208
ovl_Bg_Gnd_Firemeiro,False,1360,1504,0.904,-144
ovl_Bg_Gnd_Iceblock,False,4336,4512,0.961,-176
ovl_Bg_Gnd_Nisekabe,False,368,368,1.0,0
ovl_Bg_Gnd_Soulmeiro,False,2144,2288,0.937,-144
ovl_Bg_Haka,False,1728,1856,0.931,-128
ovl_Bg_Haka_Gate,False,4240,4544,0.933,-304
ovl_Bg_Haka_Huta,False,2720,2688,1.012,32
ovl_Bg_Haka_Megane,False,1024,1008,1.016,16
ovl_Bg_Haka_MeganeBG,False,1728,1712,1.009,16
ovl_Bg_Haka_Sgami,False,3104,3104,1.0,0
ovl_Bg_Haka_Ship,False,2640,2976,0.887,-336
ovl_Bg_Haka_Trap,False,5584,5552,1.006,32
ovl_Bg_Haka_Tubo,False,2592,2736,0.947,-144
ovl_Bg_Haka_Water,False,2048,2240,0.914,-192
ovl_Bg_Haka_Zou,False,4592,4560,1.007,32
ovl_Bg_Heavy_Block,False,6384,6672,0.957,-288
ovl_Bg_Hidan_Curtain,False,2720,3200,0.85,-480
ovl_Bg_Hidan_Dalm,False,2128,2112,1.008,16
ovl_Bg_Hidan_Firewall,False,1888,2016,0.937,-128
ovl_Bg_Hidan_Fslift,False,1232,1200,1.027,32
ovl_Bg_Hidan_Fwbig,False,3296,3408,0.967,-112
ovl_Bg_Hidan_Hamstep,False,3760,4336,0.867,-576
ovl_Bg_Hidan_Hrock,False,2096,2096,1.0,0
ovl_Bg_Hidan_Kousi,False,1424,1728,0.824,-304
ovl_Bg_Hidan_Kowarerukabe,False,3808,4192,0.908,-384
ovl_Bg_Hidan_Rock,False,4352,4480,0.971,-128
ovl_Bg_Hidan_Rsekizou,False,3040,3264,0.931,-224
ovl_Bg_Hidan_Sekizou,False,5200,5392,0.964,-192
ovl_Bg_Hidan_Sima,False,3840,4080,0.941,-240
ovl_Bg_Hidan_Syoku,False,1120,1104,1.014,16
ovl_Bg_Ice_Objects,False,3904,3888,1.004,16
ovl_Bg_Ice_Shelter,False,4672,4992,0.936,-320
ovl_Bg_Ice_Shutter,False,1136,1120,1.014,16
ovl_Bg_Ice_Turara,False,2096,2080,1.008,16
ovl_Bg_Ingate,False,912,1056,0.864,-144
ovl_Bg_Jya_1flift,False,1680,1888,0.89,-208
ovl_Bg_Jya_Amishutter,False,912,1056,0.864,-144
ovl_Bg_Jya_Bigmirror,False,2128,2752,0.773,-624
ovl_Bg_Jya_Block,False,624,768,0.812,-144
ovl_Bg_Jya_Bombchuiwa,False,2880,3328,0.865,-448
ovl_Bg_Jya_Bombiwa,False,1472,1872,0.786,-400
ovl_Bg_Jya_Cobra,False,7488,8320,0.9,-832
ovl_Bg_Jya_Goroiwa,False,1920,1872,1.026,48
ovl_Bg_Jya_Haheniron,False,2032,2016,1.008,16
ovl_Bg_Jya_Ironobj,False,3504,3744,0.936,-240
ovl_Bg_Jya_Kanaami,False,944,1120,0.843,-176
ovl_Bg_Jya_Lift,False,1360,1424,0.955,-64
ovl_Bg_Jya_Megami,False,4592,4880,0.941,-288
ovl_Bg_Jya_Zurerukabe,False,1712,2096,0.817,-384
ovl_Bg_Menkuri_Eye,False,1168,1328,0.88,-160
ovl_Bg_Menkuri_Kaiten,False,400,384,1.042,16
ovl_Bg_Menkuri_Nisekabe,False,336,336,1.0,0
ovl_Bg_Mizu_Bwall,False,5328,6064,0.879,-736
ovl_Bg_Mizu_Movebg,False,4480,4624,0.969,-144
ovl_Bg_Mizu_Shutter,False,2048,2192,0.934,-144
ovl_Bg_Mizu_Uzu,False,464,464,1.0,0
ovl_Bg_Mizu_Water,False,3280,3792,0.865,-512
ovl_Bg_Mjin,False,1008,1088,0.926,-80
ovl_Bg_Mori_Bigst,False,2352,3136,0.75,-784
ovl_Bg_Mori_Elevator,False,2800,3424,0.818,-624
ovl_Bg_Mori_Hashigo,False,2240,2816,0.795,-576
ovl_Bg_Mori_Hashira4,False,1408,1888,0.746,-480
ovl_Bg_Mori_Hineri,False,3408,3696,0.922,-288
ovl_Bg_Mori_Idomizu,False,1600,1920,0.833,-320
ovl_Bg_Mori_Kaitenkabe,False,1648,1968,0.837,-320
ovl_Bg_Mori_Rakkatenjo,False,2432,3232,0.752,-800
ovl_Bg_Po_Event,False,7728,7824,0.988,-96
ovl_Bg_Po_Syokudai,False,2416,2608,0.926,-192
ovl_Bg_Pushbox,False,768,880,0.873,-112
ovl_Bg_Relay_Objects,False,1968,1936,1.017,32
ovl_Bg_Spot00_Break,False,416,416,1.0,0
ovl_Bg_Spot00_Hanebasi,False,4368,4672,0.935,-304
ovl_Bg_Spot01_Fusya,False,672,800,0.84,-128
ovl_Bg_Spot01_Idohashira,False,3072,3584,0.857,-512
ovl_Bg_Spot01_Idomizu,False,800,928,0.862,-128
ovl_Bg_Spot01_Idosoko,False,528,704,0.75,-176
ovl_Bg_Spot01_Objects2,False,1216,1312,0.927,-96
ovl_Bg_Spot02_Objects,False,4960,5248,0.945,-288
ovl_Bg_Spot03_Taki,False,2336,2448,0.954,-112
ovl_Bg_Spot05_Soko,False,800,784,1.02,16
ovl_Bg_Spot06_Objects,False,5120,5296,0.967,-176
ovl_Bg_Spot07_Taki,False,1520,1696,0.896,-176
ovl_Bg_Spot08_Bakudankabe,False,1696,1680,1.01,16
ovl_Bg_Spot08_Iceblock,False,4160,4480,0.929,-320
ovl_Bg_Spot09_Obj,False,1312,1696,0.774,-384
ovl_Bg_Spot11_Bakudankabe,False,1600,1648,0.971,-48
ovl_Bg_Spot11_Oasis,False,1840,1952,0.943,-112
ovl_Bg_Spot12_Gate,False,1040,1168,0.89,-128
ovl_Bg_Spot12_Saku,False,1216,1344,0.905,-128
ovl_Bg_Spot15_Rrbox,False,3552,3824,0.929,-272
ovl_Bg_Spot15_Saku,False,832,992,0.839,-160
ovl_Bg_Spot16_Bombstone,False,5456,6160,0.886,-704
ovl_Bg_Spot16_Doughnut,False,1472,1920,0.767,-448
ovl_Bg_Spot17_Bakudankabe,False,1776,2112,0.841,-336
ovl_Bg_Spot17_Funen,False,592,784,0.755,-192
ovl_Bg_Spot18_Basket,False,4080,4208,0.97,-128
ovl_Bg_Spot18_Futa,False,416,400,1.04,16
ovl_Bg_Spot18_Obj,False,2256,2752,0.82,-496
ovl_Bg_Spot18_Shutter,False,1360,1344,1.012,16
ovl_Bg_Sst_Floor,False,1376,1520,0.905,-144
ovl_Bg_Toki_Hikari,False,3488,3904,0.893,-416
ovl_Bg_Toki_Swd,False,5712,5824,0.981,-112
ovl_Bg_Treemouth,False,5728,5856,0.978,-128
ovl_Bg_Umajump,False,400,384,1.042,16
ovl_Bg_Vb_Sima,False,1824,1952,0.934,-128
ovl_Bg_Ydan_Hasi,False,1968,2112,0.932,-144
ovl_Bg_Ydan_Maruta,False,1760,1744,1.009,16
ovl_Bg_Ydan_Sp,False,5920,6160,0.961,-240
ovl_Bg_Zg,False,1104,1392,0.793,-288
ovl_Boss_Dodongo,False,39680,39984,0.992,-304
ovl_Boss_Fd,False,29536,30896,0.956,-1360
ovl_Boss_Fd2,False,15664,16896,0.927,-1232
ovl_Boss_Ganon,False,139952,142160,0.984,-2208
ovl_Boss_Ganon2,False,70480,72672,0.97,-2192
ovl_Boss_Ganondrof,False,19856,21456,0.925,-1600
ovl_Boss_Goma,False,24480,24816,0.986,-336
ovl_Boss_Mo,False,47824,49088,0.974,-1264
ovl_Boss_Sst,False,50576,50880,0.994,-304
ovl_Boss_Tw,False,78160,80752,0.968,-2592
ovl_Boss_Va,False,59536,60560,0.983,-1024
ovl_Demo_6K,False,11616,12672,0.917,-1056
ovl_Demo_Du,False,14304,14816,0.965,-512
ovl_Demo_Ec,False,14432,15008,0.962,-576
ovl_Demo_Effect,False,23456,25664,0.914,-2208
ovl_Demo_Ext,False,2384,2736,0.871,-352
ovl_Demo_Geff,False,2080,2800,0.743,-720
ovl_Demo_Gj,False,15536,16192,0.959,-656
ovl_Demo_Go,False,3408,3584,0.951,-176
ovl_Demo_Gt,False,22032,23696,0.93,-1664
ovl_Demo_Ik,False,5392,6368,0.847,-976
ovl_Demo_Im,False,16240,17056,0.952,-816
ovl_Demo_Kankyo,False,15520,16640,0.933,-1120
ovl_Demo_Kekkai,False,4848,5264,0.921,-416
ovl_Demo_Sa,False,11040,11728,0.941,-688
ovl_Demo_Shd,False,9232,9360,0.986,-128
ovl_Demo_Tre_Lgt,False,1808,2096,0.863,-288
ovl_Door_Ana,False,1648,1776,0.928,-128
ovl_Door_Gerudo,False,1520,1648,0.922,-128
ovl_Door_Killer,False,5488,5712,0.961,-224
ovl_Door_Shutter,False,8896,9088,0.979,-192
ovl_Door_Toki,False,352,352,1.0,0
ovl_Door_Warp1,False,17152,17696,0.969,-544
ovl_Efc_Erupc,False,2800,3104,0.902,-304
ovl_Eff_Dust,False,5072,5344,0.949,-272
ovl_Effect_Ss_Blast,False,912,1024,0.891,-112
ovl_Effect_Ss_Bomb,False,1072,1184,0.905,-112
ovl_Effect_Ss_Bomb2,False,2304,2544,0.906,-240
ovl_Effect_Ss_Bubble,False,1152,1296,0.889,-144
ovl_Effect_Ss_D_Fire,False,1264,1360,0.929,-96
ovl_Effect_Ss_Dead_Db,False,1248,1344,0.929,-96
ovl_Effect_Ss_Dead_Dd,False,1424,1584,0.899,-160
ovl_Effect_Ss_Dead_Ds,False,1152,1312,0.878,-160
ovl_Effect_Ss_Dead_Sound,False,320,384,0.833,-64
ovl_Effect_Ss_Dt_Bubble,False,1424,1568,0.908,-144
ovl_Effect_Ss_Dust,False,2112,2192,0.964,-80
ovl_Effect_Ss_En_Fire,False,1872,2000,0.936,-128
ovl_Effect_Ss_En_Ice,False,2240,2448,0.915,-208
ovl_Effect_Ss_Extra,False,960,1120,0.857,-160
ovl_Effect_Ss_Fcircle,False,1200,1344,0.893,-144
ovl_Effect_Ss_Fhg_Flash,False,3968,4320,0.919,-352
ovl_Effect_Ss_Fire_Tail,False,1792,1936,0.926,-144
ovl_Effect_Ss_G_Fire,False,656,640,1.025,16
ovl_Effect_Ss_G_Magma,False,608,592,1.027,16
ovl_Effect_Ss_G_Magma2,False,1296,1472,0.88,-176
ovl_Effect_Ss_G_Ripple,False,1376,1488,0.925,-112
ovl_Effect_Ss_G_Spk,False,1456,1552,0.938,-96
ovl_Effect_Ss_G_Splash,False,1200,1200,1.0,0
ovl_Effect_Ss_Hahen,False,1600,1888,0.847,-288
ovl_Effect_Ss_HitMark,False,1360,1456,0.934,-96
ovl_Effect_Ss_Ice_Piece,False,1088,1264,0.861,-176
ovl_Effect_Ss_Ice_Smoke,False,1248,1472,0.848,-224
ovl_Effect_Ss_K_Fire,False,1088,1232,0.883,-144
ovl_Effect_Ss_Kakera,False,4240,4496,0.943,-256
ovl_Effect_Ss_KiraKira,False,1648,1760,0.936,-112
ovl_Effect_Ss_Lightning,False,1744,1856,0.94,-112
ovl_Effect_Ss_Sibuki,False,1744,1840,0.948,-96
ovl_Effect_Ss_Sibuki2,False,816,976,0.836,-160
ovl_Effect_Ss_Solder_Srch_Ball,False,432,416,1.038,16
ovl_Effect_Ss_Stick,False,928,1072,0.866,-144
ovl_Effect_Ss_Stone1,False,896,1056,0.848,-160
ovl_Elf_Msg,False,1520,3040,0.5,-1520
ovl_Elf_Msg2,False,1136,2080,0.546,-944
ovl_En_Am,False,9216,9296,0.991,-80
ovl_En_Ani,False,3440,3504,0.982,-64
ovl_En_Anubice,False,4784,5248,0.912,-464
ovl_En_Anubice_Fire,False,3520,3680,0.957,-160
ovl_En_Anubice_Tag,False,720,976,0.738,-256
ovl_En_Arow_Trap,False,336,336,1.0,0
ovl_En_Arrow,False,5888,6112,0.963,-224
ovl_En_Attack_Niw,False,4704,4688,1.003,16
ovl_En_Ba,False,7888,8080,0.976,-192
ovl_En_Bb,False,15584,15696,0.993,-112
ovl_En_Bdfire,False,2976,3120,0.954,-144
ovl_En_Bigokuta,False,11008,11328,0.972,-320
ovl_En_Bili,False,8912,8976,0.993,-64
ovl_En_Bird,False,1216,1200,1.013,16
ovl_En_Blkobj,False,1376,1648,0.835,-272
ovl_En_Bom,False,3792,3936,0.963,-144
ovl_En_Bom_Bowl_Man,False,5440,6160,0.883,-720
ovl_En_Bom_Bowl_Pit,False,2416,2544,0.95,-128
ovl_En_Bom_Chu,False,5792,5936,0.976,-144
ovl_En_Bombf,False,5264,5408,0.973,-144
ovl_En_Boom,False,2256,2368,0.953,-112
ovl_En_Box,False,6992,7488,0.934,-496
ovl_En_Brob,False,4336,4336,1.0,0
ovl_En_Bubble,False,5152,5232,0.985,-80
ovl_En_Butte,False,5584,5744,0.972,-160
ovl_En_Bw,False,13200,13312,0.992,-112
ovl_En_Bx,False,2816,2992,0.941,-176
ovl_En_Changer,False,2528,3872,0.653,-1344
ovl_En_Clear_Tag,False,35696,36384,0.981,-688
ovl_En_Cow,False,5216,5184,1.006,32
ovl_En_Crow,False,5792,5744,1.008,48
ovl_En_Cs,False,4656,4736,0.983,-80
ovl_En_Daiku,False,5952,6128,0.971,-176
ovl_En_Daiku_Kakariko,False,5056,5296,0.955,-240
ovl_En_Dekubaba,False,15024,15760,0.953,-736
ovl_En_Dekunuts,False,6144,6112,1.005,32
ovl_En_Dh,False,6880,6976,0.986,-96
ovl_En_Dha,False,4096,4080,1.004,16
ovl_En_Diving_Game,False,6576,6880,0.956,-304
ovl_En_Dns,False,5008,5520,0.907,-512
ovl_En_Dnt_Demo,False,3360,4608,0.729,-1248
ovl_En_Dnt_Jiji,False,5408,6112,0.885,-704
ovl_En_Dnt_Nomal,False,11776,12544,0.939,-768
ovl_En_Dodojr,False,7840,7824,1.002,16
ovl_En_Dodongo,False,11680,11648,1.003,32
ovl_En_Dog,False,4528,4608,0.983,-80
ovl_En_Door,False,3648,3680,0.991,-32
ovl_En_Ds,False,3104,3072,1.01,32
ovl_En_Du,False,6800,6848,0.993,-48
ovl_En_Dy_Extra,False,1440,1696,0.849,-256
ovl_En_Eg,False,432,528,0.818,-96
ovl_En_Eiyer,False,7264,7312,0.993,-48
ovl_En_Elf,False,18880,19184,0.984,-304
ovl_En_Encount1,False,2912,4720,0.617,-1808
ovl_En_Encount2,False,4656,5392,0.864,-736
ovl_En_Ex_Item,False,4480,5488,0.816,-1008
ovl_En_Ex_Ruppy,False,4288,4784,0.896,-496
ovl_En_Fd,False,11424,11760,0.971,-336
ovl_En_Fd_Fire,False,3344,3504,0.954,-160
ovl_En_Fhg_Fire,False,9888,10688,0.925,-800
ovl_En_Fire_Rock,False,4368,5200,0.84,-832
ovl_En_Firefly,False,8560,8720,0.982,-160
ovl_En_Fish,False,8464,8848,0.957,-384
ovl_En_Floormas,False,13280,13456,0.987,-176
ovl_En_Fr,False,10896,11888,0.917,-992
ovl_En_Fu,False,3392,3456,0.981,-64
ovl_En_Fw,False,6080,6176,0.984,-96
ovl_En_Fz,False,8208,8448,0.972,-240
ovl_En_G_Switch,False,6176,7840,0.788,-1664
ovl_En_Ganon_Mant,False,16944,17056,0.993,-112
ovl_En_Ganon_Organ,False,28736,29056,0.989,-320
ovl_En_Gb,False,5936,6128,0.969,-192
ovl_En_Ge1,False,8240,8800,0.936,-560
ovl_En_Ge2,False,6560,6736,0.974,-176
ovl_En_Ge3,False,3136,3312,0.947,-176
ovl_En_GeldB,False,21424,21568,0.993,-144
ovl_En_GirlA,False,10528,12176,0.865,-1648
ovl_En_Gm,False,3376,3728,0.906,-352
ovl_En_Go,False,17984,18368,0.979,-384
ovl_En_Go2,False,24640,24976,0.987,-336
ovl_En_Goma,False,11440,11744,0.974,-304
ovl_En_Goroiwa,False,9152,9856,0.929,-704
ovl_En_Gs,False,7792,7936,0.982,-144
ovl_En_Guest,False,2464,2864,0.86,-400
ovl_En_Hata,False,1424,1408,1.011,16
ovl_En_Heishi1,False,5392,7120,0.757,-1728
ovl_En_Heishi2,False,8704,10144,0.858,-1440
ovl_En_Heishi3,False,2512,2704,0.929,-192
ovl_En_Heishi4,False,3840,4400,0.873,-560
ovl_En_Hintnuts,False,6704,6672,1.005,32
ovl_En_Holl,False,4048,4128,0.981,-80
ovl_En_Honotrap,False,5472,5824,0.94,-352
ovl_En_Horse,False,49760,49760,1.0,0
ovl_En_Horse_Game_Check,False,4304,4368,0.985,-64
ovl_En_Horse_Ganon,False,3456,3440,1.005,16
ovl_En_Horse_Link_Child,False,7680,7808,0.984,-128
ovl_En_Horse_Normal,False,9760,9856,0.99,-96
ovl_En_Horse_Zelda,False,2800,2768,1.012,32
ovl_En_Hs,False,2976,3072,0.969,-96
ovl_En_Hs2,False,1504,1552,0.969,-48
ovl_En_Hy,False,14656,14912,0.983,-256
ovl_En_Ice_Hono,False,4592,4896,0.938,-304
ovl_En_Ik,False,18000,19600,0.918,-1600
ovl_En_In,False,11680,11888,0.983,-208
ovl_En_Insect,False,9504,9792,0.971,-288
ovl_En_Ishi,False,37200,37408,0.994,-208
ovl_En_It,False,400,384,1.042,16
ovl_En_Jj,False,5584,5648,0.989,-64
ovl_En_Js,False,2512,2448,1.026,64
ovl_En_Jsjutan,False,19920,20080,0.992,-160
ovl_En_Kakasi,False,3392,3744,0.906,-352
ovl_En_Kakasi2,False,1824,3344,0.545,-1520
ovl_En_Kakasi3,False,4320,4736,0.912,-416
ovl_En_Kanban,False,12624,13232,0.954,-608
ovl_En_Karebaba,False,6384,6752,0.945,-368
ovl_En_Ko,False,16704,16880,0.99,-176
ovl_En_Kusa,False,5344,5552,0.963,-208
ovl_En_Kz,False,5536,5616,0.986,-80
ovl_En_Light,False,3584,3728,0.961,-144
ovl_En_Lightbox,False,1152,1136,1.014,16
ovl_En_M_Fire1,False,416,416,1.0,0
ovl_En_M_Thunder,False,5632,5808,0.97,-176
ovl_En_Ma1,False,4832,4880,0.99,-48
ovl_En_Ma2,False,4192,4352,0.963,-160
ovl_En_Ma3,False,4016,4192,0.958,-176
ovl_En_Mag,False,9504,9552,0.995,-48
ovl_En_Mb,False,16944,16896,1.003,48
ovl_En_Md,False,9840,9904,0.994,-64
ovl_En_Mk,False,3728,3696,1.009,32
ovl_En_Mm,False,5728,5856,0.978,-128
ovl_En_Mm2,False,3520,3792,0.928,-272
ovl_En_Ms,False,1776,1792,0.991,-16
ovl_En_Mu,False,2336,2416,0.967,-80
ovl_En_Nb,False,17872,18928,0.944,-1056
ovl_En_Niw,False,13104,14336,0.914,-1232
ovl_En_Niw_Girl,False,2768,3264,0.848,-496
ovl_En_Niw_Lady,False,6400,7696,0.832,-1296
ovl_En_Nutsball,False,1568,1680,0.933,-112
ovl_En_Nwc,False,2592,2768,0.936,-176
ovl_En_Ny,False,6464,6896,0.937,-432
ovl_En_OE2,False,224,192,1.167,32
ovl_En_Okarina_Effect,False,960,1472,0.652,-512
ovl_En_Okarina_Tag,False,5376,6464,0.832,-1088
ovl_En_Okuta,False,9696,9792,0.99,-96
ovl_En_Ossan,False,26080,29312,0.89,-3232
ovl_En_Owl,False,15264,16048,0.951,-784
ovl_En_Part,False,5728,5840,0.981,-112
ovl_En_Peehat,False,14080,14352,0.981,-272
ovl_En_Po_Desert,False,3520,3664,0.961,-144
ovl_En_Po_Field,False,14848,15280,0.972,-432
ovl_En_Po_Relay,False,5904,6224,0.949,-320
ovl_En_Po_Sisters,False,19696,19904,0.99,-208
ovl_En_Poh,False,16880,17264,0.978,-384
ovl_En_Pu_box,False,832,832,1.0,0
ovl_En_Rd,False,10432,10448,0.998,-16
ovl_En_Reeba,False,6768,7264,0.932,-496
ovl_En_River_Sound,False,2448,2432,1.007,16
ovl_En_Rl,False,3808,4496,0.847,-688
ovl_En_Rr,False,9520,10192,0.934,-672
ovl_En_Ru1,False,30368,31040,0.978,-672
ovl_En_Ru2,False,11648,12304,0.947,-656
ovl_En_Sa,False,8816,8848,0.996,-32
ovl_En_Sb,False,5184,5248,0.988,-64
ovl_En_Scene_Change,False,304,432,0.704,-128
ovl_En_Sda,False,5680,6208,0.915,-528
ovl_En_Shopnuts,False,3856,3952,0.976,-96
ovl_En_Si,False,1280,1264,1.013,16
ovl_En_Siofuki,False,3504,3616,0.969,-112
ovl_En_Skb,False,6384,6416,0.995,-32
ovl_En_Skj,False,14656,15344,0.955,-688
ovl_En_Skjneedle,False,784,960,0.817,-176
ovl_En_Ssh,False,9712,9760,0.995,-48
ovl_En_St,False,11376,11440,0.994,-64
ovl_En_Sth,False,16576,16992,0.976,-416
ovl_En_Stream,False,1424,1552,0.918,-128
ovl_En_Sw,False,14192,14464,0.981,-272
ovl_En_Syateki_Itm,False,3488,4544,0.768,-1056
ovl_En_Syateki_Man,False,3520,4224,0.833,-704
ovl_En_Syateki_Niw,False,8336,8624,0.967,-288
ovl_En_Ta,False,14784,15040,0.983,-256
ovl_En_Takara_Man,False,2240,2512,0.892,-272
ovl_En_Tana,False,688,1072,0.642,-384
ovl_En_Tg,False,1760,1824,0.965,-64
ovl_En_Tite,False,11680,11904,0.981,-224
ovl_En_Tk,False,7728,8080,0.956,-352
ovl_En_Torch,False,240,240,1.0,0
ovl_En_Torch2,False,10080,10160,0.992,-80
ovl_En_Toryo,False,3216,3184,1.01,32
ovl_En_Tp,False,7792,7952,0.98,-160
ovl_En_Tr,False,6400,6512,0.983,-112
ovl_En_Trap,False,4768,4752,1.003,16
ovl_En_Tubo_Trap,False,3232,3520,0.918,-288
ovl_En_Vali,False,9920,10240,0.969,-320
ovl_En_Vase,False,256,240,1.067,16
ovl_En_Vb_Ball,False,4528,4704,0.963,-176
ovl_En_Viewer,False,11936,12864,0.928,-928
ovl_En_Vm,False,6336,6544,0.968,-208
ovl_En_Wall_Tubo,False,1264,1840,0.687,-576
ovl_En_Wallmas,False,6672,6912,0.965,-240
ovl_En_Weather_Tag,False,3824,4720,0.81,-896
ovl_En_Weiyer,False,6656,6688,0.995,-32
ovl_En_Wf,False,17168,17328,0.991,-160
ovl_En_Wonder_Item,False,3152,4016,0.785,-864
ovl_En_Wonder_Talk,False,1680,3552,0.473,-1872
ovl_En_Wonder_Talk2,False,1696,4256,0.398,-2560
ovl_En_Wood02,False,4560,4704,0.969,-144
ovl_En_Xc,False,26464,27568,0.96,-1104
ovl_En_Yabusame_Mark,False,1744,3072,0.568,-1328
ovl_En_Yukabyun,False,1552,1680,0.924,-128
ovl_En_Zf,False,27360,27360,1.0,0
ovl_En_Zl1,False,15888,15952,0.996,-64
ovl_En_Zl2,False,18176,18976,0.958,-800
ovl_En_Zl3,False,32336,33792,0.957,-1456
ovl_En_Zl4,False,18992,19056,0.997,-64
ovl_En_Zo,False,9664,10144,0.953,-480
ovl_En_fHG,False,10544,11616,0.908,-1072
ovl_End_Title,False,16672,17024,0.979,-352
ovl_Fishing,False,80544,83664,0.963,-3120
ovl_Item_B_Heart,False,1040,1184,0.878,-144
ovl_Item_Etcetera,False,2256,2544,0.887,-288
ovl_Item_Inbox,False,352,336,1.048,16
ovl_Item_Ocarina,False,2000,2032,0.984,-32
ovl_Item_Shield,False,2576,2736,0.942,-160
ovl_Magic_Dark,False,6224,6560,0.949,-336
ovl_Magic_Fire,False,8960,9104,0.984,-144
ovl_Magic_Wind,False,7424,8016,0.926,-592
ovl_Mir_Ray,False,6320,6704,0.943,-384
ovl_Obj_Bean,False,10128,10720,0.945,-592
ovl_Obj_Blockstop,False,416,400,1.04,16
ovl_Obj_Bombiwa,False,1392,1392,1.0,0
ovl_Obj_Comb,False,2144,2240,0.957,-96
ovl_Obj_Dekujr,False,1600,1760,0.909,-160
ovl_Obj_Elevator,False,960,1168,0.822,-208
ovl_Obj_Hamishi,False,2128,2256,0.943,-128
ovl_Obj_Hana,False,784,768,1.021,16
ovl_Obj_Hsblock,False,1488,1792,0.83,-304
ovl_Obj_Ice_Poly,False,2480,2624,0.945,-144
ovl_Obj_Kibako,False,3328,3376,0.986,-48
ovl_Obj_Kibako2,False,1728,1792,0.964,-64
ovl_Obj_Lift,False,2592,2768,0.936,-176
ovl_Obj_Lightswitch,False,5168,5840,0.885,-672
ovl_Obj_Makekinsuta,False,336,672,0.5,-336
ovl_Obj_Makeoshihiki,False,1168,1424,0.82,-256
ovl_Obj_Mure,False,4112,5280,0.779,-1168
ovl_Obj_Mure2,False,2592,2704,0.959,-112
ovl_Obj_Mure3,False,2000,1968,1.016,32
ovl_Obj_Oshihiki,False,6832,7760,0.88,-928
ovl_Obj_Roomtimer,False,592,576,1.028,16
ovl_Obj_Switch,False,7648,8352,0.916,-704
ovl_Obj_Syokudai,False,3136,3296,0.951,-160
ovl_Obj_Timeblock,False,3152,3520,0.895,-368
ovl_Obj_Tsubo,False,4080,4240,0.962,-160
ovl_Obj_Warp2block,False,2864,3248,0.882,-384
ovl_Object_Kankyo,False,12928,13776,0.938,-848
ovl_Oceff_Spot,False,3888,4208,0.924,-320
ovl_Oceff_Storm,False,7088,7344,0.965,-256
ovl_Oceff_Wipe,False,3456,3616,0.956,-160
ovl_Oceff_Wipe2,False,6000,6208,0.966,-208
ovl_Oceff_Wipe3,False,5968,6176,0.966,-208
ovl_Oceff_Wipe4,False,4064,4272,0.951,-208
ovl_Shot_Sun,False,1728,1856,0.931,-128
gameplay_keep,True,354224,354224,1.0,0
gameplay_field_keep,True,54064,54064,1.0,0
gameplay_dangeon_keep,True,97008,97008,1.0,0
gameplay_object_exchange_static,True,16,16,1.0,0
object_link_boy,True,227328,227328,1.0,0
object_link_child,True,184192,184192,1.0,0
object_box,True,24576,24576,1.0,0
object_human,True,78208,78208,1.0,0
object_okuta,True,15488,15488,1.0,0
object_poh,True,20704,20704,1.0,0
object_wallmaster,True,41072,41072,1.0,0
object_dy_obj,True,120112,120112,1.0,0
object_firefly,True,6336,6336,1.0,0
object_dodongo,True,39232,39232,1.0,0
object_fire,True,16544,16544,1.0,0
object_niw,True,9536,9536,1.0,0
object_tite,True,14896,14896,1.0,0
object_reeba,True,7920,7920,1.0,0
object_peehat,True,7312,7312,1.0,0
object_kingdodongo,True,199904,199904,1.0,0
object_horse,True,57104,57104,1.0,0
object_zf,True,91040,91040,1.0,0
object_goma,True,128512,128512,1.0,0
object_zl1,True,82880,82880,1.0,0
object_gol,True,16928,16928,1.0,0
object_bubble,True,4288,4288,1.0,0
object_dodojr,True,8432,8432,1.0,0
object_torch2,True,18288,18288,1.0,0
object_bl,True,22608,22608,1.0,0
object_tp,True,7408,7408,1.0,0
object_oA1,True,18192,18192,1.0,0
object_st,True,23472,23472,1.0,0
object_bw,True,8800,8800,1.0,0
object_ei,True,13344,13344,1.0,0
object_horse_normal,True,40896,40896,1.0,0
object_oB1,True,26288,26288,1.0,0
object_o_anime,True,8528,8528,1.0,0
object_spot04_objects,True,5824,5824,1.0,0
object_ddan_objects,True,34656,34656,1.0,0
object_hidan_objects,True,97568,97568,1.0,0
object_horse_ganon,True,49296,49296,1.0,0
object_oA2,True,22224,22224,1.0,0
object_spot00_objects,True,7184,7184,1.0,0
object_mb,True,82336,82336,1.0,0
object_bombf,True,6656,6656,1.0,0
object_sk2,True,59392,59392,1.0,0
object_oE1,True,26640,26640,1.0,0
object_oE_anime,True,20576,20576,1.0,0
object_oE2,True,23152,23152,1.0,0
object_ydan_objects,True,36992,36992,1.0,0
object_gnd,True,77824,77824,1.0,0
object_am,True,23376,23376,1.0,0
object_dekubaba,True,14784,14784,1.0,0
object_oA3,True,8496,8496,1.0,0
object_oA4,True,5936,5936,1.0,0
object_oA5,True,5808,5808,1.0,0
object_oA6,True,6656,6656,1.0,0
object_oA7,True,5456,5456,1.0,0
object_jj,True,47808,47808,1.0,0
object_oA8,True,6064,6064,1.0,0
object_oA9,True,1312,1312,1.0,0
object_oB2,True,16608,16608,1.0,0
object_oB3,True,17552,17552,1.0,0
object_oB4,True,6256,6256,1.0,0
object_horse_zelda,True,29024,29024,1.0,0
object_opening_demo1,True,20576,20576,1.0,0
object_warp1,True,11440,11440,1.0,0
object_b_heart,True,1600,1600,1.0,0
object_dekunuts,True,13920,13920,1.0,0
object_oE3,True,28960,28960,1.0,0
object_oE4,True,20432,20432,1.0,0
object_menkuri_objects,True,35600,35600,1.0,0
object_oE5,True,21952,21952,1.0,0
object_oE6,True,11856,11856,1.0,0
object_oE7,True,10848,10848,1.0,0
object_oE8,True,13264,13264,1.0,0
object_oE9,True,12048,12048,1.0,0
object_oE10,True,10704,10704,1.0,0
object_oE11,True,12784,12784,1.0,0
object_oE12,True,14272,14272,1.0,0
object_vali,True,18512,18512,1.0,0
object_oA10,True,11952,11952,1.0,0
object_oA11,True,5568,5568,1.0,0
object_mizu_objects,True,45856,45856,1.0,0
object_fhg,True,74208,74208,1.0,0
object_ossan,True,39760,39760,1.0,0
object_mori_hineri1,True,21744,21744,1.0,0
object_Bb,True,6720,6720,1.0,0
object_toki_objects,True,33872,33872,1.0,0
object_yukabyun,True,5360,5360,1.0,0
object_zl2,True,68992,68992,1.0,0
object_mjin,True,4752,4752,1.0,0
object_mjin_flash,True,4096,4096,1.0,0
object_mjin_dark,True,4096,4096,1.0,0
object_mjin_flame,True,4096,4096,1.0,0
object_mjin_ice,True,4096,4096,1.0,0
object_mjin_soul,True,4096,4096,1.0,0
object_mjin_wind,True,4096,4096,1.0,0
object_mjin_oka,True,7008,7008,1.0,0
object_haka_objects,True,120496,120496,1.0,0
object_spot06_objects,True,11680,11680,1.0,0
object_ice_objects,True,36176,36176,1.0,0
object_relay_objects,True,13872,13872,1.0,0
object_mori_hineri1a,True,13504,13504,1.0,0
object_mori_hineri2,True,17408,17408,1.0,0
object_mori_hineri2a,True,24752,24752,1.0,0
object_mori_objects,True,35344,35344,1.0,0
object_mori_tex,True,40448,40448,1.0,0
object_spot08_obj,True,22016,22016,1.0,0
object_warp2,True,16,16,1.0,0
object_hata,True,12256,12256,1.0,0
object_bird,True,8608,8608,1.0,0
object_wood02,True,34768,34768,1.0,0
object_lightbox,True,8000,8000,1.0,0
object_pu_box,True,5632,5632,1.0,0
object_trap,True,9184,9184,1.0,0
object_vase,True,5520,5520,1.0,0
object_im,True,74288,74288,1.0,0
object_ta,True,58352,58352,1.0,0
object_tk,True,48720,48720,1.0,0
object_xc,True,114944,114944,1.0,0
object_vm,True,16240,16240,1.0,0
object_bv,True,127408,127408,1.0,0
object_hakach_objects,True,27376,27376,1.0,0
object_efc_crystal_light,True,2720,2720,1.0,0
object_efc_fire_ball,True,3328,3328,1.0,0
object_efc_flash,True,16,16,1.0,0
object_efc_lgt_shower,True,4816,4816,1.0,0
object_efc_star_field,True,6096,6096,1.0,0
object_god_lgt,True,17232,17232,1.0,0
object_light_ring,True,4736,4736,1.0,0
object_triforce_spot,True,10512,10512,1.0,0
object_medal,True,20800,20800,1.0,0
object_bdan_objects,True,52496,52496,1.0,0
object_sd,True,50912,50912,1.0,0
object_rd,True,61424,61424,1.0,0
object_po_sisters,True,58304,58304,1.0,0
object_heavy_object,True,6880,6880,1.0,0
object_gndd,True,72192,72192,1.0,0
object_fd,True,71280,71280,1.0,0
object_du,True,73776,73776,1.0,0
object_fw,True,32224,32224,1.0,0
object_horse_link_child,True,35616,35616,1.0,0
object_spot02_objects,True,91680,91680,1.0,0
object_haka,True,5216,5216,1.0,0
object_ru1,True,80512,80512,1.0,0
object_syokudai,True,15504,15504,1.0,0
object_fd2,True,72336,72336,1.0,0
object_dh,True,37056,37056,1.0,0
object_rl,True,31568,31568,1.0,0
object_efc_tw,True,4848,4848,1.0,0
object_demo_tre_lgt,True,16,16,1.0,0
object_gi_key,True,2592,2592,1.0,0
object_mir_ray,True,7424,7424,1.0,0
object_brob,True,6816,6816,1.0,0
object_gi_jewel,True,13952,13952,1.0,0
object_spot09_obj,True,100496,100496,1.0,0
object_spot18_obj,True,51728,51728,1.0,0
object_bdoor,True,30144,30144,1.0,0
object_spot17_obj,True,6192,6192,1.0,0
object_shop_dungen,True,14880,14880,1.0,0
object_nb,True,98784,98784,1.0,0
object_mo,True,36976,36976,1.0,0
object_sb,True,11424,11424,1.0,0
object_gi_melody,True,3360,3360,1.0,0
object_gi_heart,True,496,496,1.0,0
object_gi_compass,True,3344,3344,1.0,0
object_gi_bosskey,True,4112,4112,1.0,0
object_gi_medal,True,21360,21360,1.0,0
object_gi_nuts,True,4544,4544,1.0,0
object_sa,True,86576,86576,1.0,0
object_gi_hearts,True,6064,6064,1.0,0
object_gi_arrowcase,True,3248,3248,1.0,0
object_gi_bombpouch,True,3680,3680,1.0,0
object_in,True,101456,101456,1.0,0
object_tr,True,77360,77360,1.0,0
object_spot16_obj,True,5376,5376,1.0,0
object_oE1s,True,25952,25952,1.0,0
object_oE4s,True,19968,19968,1.0,0
object_os_anime,True,42560,42560,1.0,0
object_gi_bottle,True,2288,2288,1.0,0
object_gi_stick,True,1728,1728,1.0,0
object_gi_map,True,4448,4448,1.0,0
object_oF1d_map,True,66976,66976,1.0,0
object_ru2,True,63696,63696,1.0,0
object_gi_shield_1,True,3408,3408,1.0,0
object_dekujr,True,13584,13584,1.0,0
object_gi_magicpot,True,4560,4560,1.0,0
object_gi_bomb_1,True,3248,3248,1.0,0
object_oF1s,True,34976,34976,1.0,0
object_ma2,True,40688,40688,1.0,0
object_gi_purse,True,7024,7024,1.0,0
object_hni,True,44912,44912,1.0,0
object_tw,True,241584,241584,1.0,0
object_rr,True,3584,3584,1.0,0
object_bxa,True,11248,11248,1.0,0
object_anubice,True,14752,14752,1.0,0
object_gi_gerudo,True,4928,4928,1.0,0
object_gi_arrow,True,6928,6928,1.0,0
object_gi_bomb_2,True,1696,1696,1.0,0
object_gi_egg,True,4896,4896,1.0,0
object_gi_scale,True,3568,3568,1.0,0
object_gi_shield_2,True,4208,4208,1.0,0
object_gi_hookshot,True,5472,5472,1.0,0
object_gi_ocarina,True,2992,2992,1.0,0
object_gi_milk,True,5232,5232,1.0,0
object_ma1,True,36224,36224,1.0,0
object_ganon,True,70912,70912,1.0,0
object_sst,True,109488,109488,1.0,0
object_ny,True,8560,8560,1.0,0
object_fr,True,46256,46256,1.0,0
object_gi_pachinko,True,3168,3168,1.0,0
object_gi_boomerang,True,3488,3488,1.0,0
object_gi_bow,True,3376,3376,1.0,0
object_gi_glasses,True,4480,4480,1.0,0
object_gi_liquid,True,6352,6352,1.0,0
object_ani,True,30464,30464,1.0,0
object_demo_6k,True,15264,15264,1.0,0
object_gi_shield_3,True,4800,4800,1.0,0
object_gi_letter,True,3584,3584,1.0,0
object_spot15_obj,True,7424,7424,1.0,0
object_jya_obj,True,115008,115008,1.0,0
object_gi_clothes,True,6240,6240,1.0,0
object_gi_bean,True,2240,2240,1.0,0
object_gi_fish,True,2384,2384,1.0,0
object_gi_saw,True,2944,2944,1.0,0
object_gi_hammer,True,3264,3264,1.0,0
object_gi_grass,True,3088,3088,1.0,0
object_gi_longsword,True,2240,2240,1.0,0
object_spot01_objects,True,9360,9360,1.0,0
object_md,True,41296,41296,1.0,0
object_km1,True,22976,22976,1.0,0
object_kw1,True,26848,26848,1.0,0
object_zo,True,49216,49216,1.0,0
object_kz,True,34528,34528,1.0,0
object_umajump,True,5232,5232,1.0,0
object_masterkokiri,True,1216,1216,1.0,0
object_masterkokirihead,True,11424,11424,1.0,0
object_mastergolon,True,272,272,1.0,0
object_masterzoora,True,1952,1952,1.0,0
object_aob,True,22192,22192,1.0,0
object_ik,True,132560,132560,1.0,0
object_ahg,True,22960,22960,1.0,0
object_cne,True,10704,10704,1.0,0
object_gi_niwatori,True,6640,6640,1.0,0
object_skj,True,36400,36400,1.0,0
object_gi_bottle_letter,True,3200,3200,1.0,0
object_bji,True,16784,16784,1.0,0
object_bba,True,17040,17040,1.0,0
object_gi_ocarina_0,True,3088,3088,1.0,0
object_ds,True,18304,18304,1.0,0
object_ane,True,28592,28592,1.0,0
object_boj,True,23744,23744,1.0,0
object_spot03_object,True,5728,5728,1.0,0
object_spot07_object,True,27952,27952,1.0,0
object_fz,True,13520,13520,1.0,0
object_bob,True,20256,20256,1.0,0
object_ge1,True,42160,42160,1.0,0
object_yabusame_point,True,3664,3664,1.0,0
object_gi_boots_2,True,7104,7104,1.0,0
object_gi_seed,True,2752,2752,1.0,0
object_gnd_magic,True,4736,4736,1.0,0
object_d_elevator,True,5008,5008,1.0,0
object_d_hsblock,True,5984,5984,1.0,0
object_d_lift,True,6144,6144,1.0,0
object_mamenoki,True,9952,9952,1.0,0
object_goroiwa,True,6304,6304,1.0,0
object_toryo,True,29024,29024,1.0,0
object_daiku,True,34928,34928,1.0,0
object_nwc,True,3488,3488,1.0,0
object_blkobj,True,80016,80016,1.0,0
object_gm,True,720,720,1.0,0
object_ms,True,15824,15824,1.0,0
object_hs,True,25200,25200,1.0,0
object_ingate,True,4592,4592,1.0,0
object_lightswitch,True,9248,9248,1.0,0
object_kusa,True,896,896,1.0,0
object_tsubo,True,6640,6640,1.0,0
object_gi_gloves,True,6496,6496,1.0,0
object_gi_coin,True,2128,2128,1.0,0
object_kanban,True,6064,6064,1.0,0
object_gjyo_objects,True,5616,5616,1.0,0
object_owl,True,65728,65728,1.0,0
object_mk,True,24064,24064,1.0,0
object_fu,True,27808,27808,1.0,0
object_gi_ki_tan_mask,True,3568,3568,1.0,0
object_gi_redead_mask,True,2704,2704,1.0,0
object_gi_skj_mask,True,3296,3296,1.0,0
object_gi_rabit_mask,True,3840,3840,1.0,0
object_gi_truth_mask,True,6240,6240,1.0,0
object_ganon_objects,True,4464,4464,1.0,0
object_siofuki,True,3504,3504,1.0,0
object_stream,True,2688,2688,1.0,0
object_mm,True,32880,32880,1.0,0
object_fa,True,15248,15248,1.0,0
object_os,True,18032,18032,1.0,0
object_gi_eye_lotion,True,2416,2416,1.0,0
object_gi_powder,True,2944,2944,1.0,0
object_gi_mushroom,True,3280,3280,1.0,0
object_gi_ticketstone,True,4768,4768,1.0,0
object_gi_brokensword,True,2448,2448,1.0,0
object_js,True,24368,24368,1.0,0
object_cs,True,34128,34128,1.0,0
object_gi_prescription,True,3104,3104,1.0,0
object_gi_bracelet,True,3056,3056,1.0,0
object_gi_soldout,True,1232,1232,1.0,0
object_gi_frog,True,4368,4368,1.0,0
object_mag,True,153920,153920,1.0,0
object_door_gerudo,True,2464,2464,1.0,0
object_gt,True,79344,79344,1.0,0
object_efc_erupc,True,10480,10480,1.0,0
object_zl2_anime1,True,46608,46608,1.0,0
object_zl2_anime2,True,43744,43744,1.0,0
object_gi_golonmask,True,6064,6064,1.0,0
object_gi_zoramask,True,5680,5680,1.0,0
object_gi_gerudomask,True,5120,5120,1.0,0
object_ganon2,True,220144,220144,1.0,0
object_ka,True,26560,26560,1.0,0
object_ts,True,20464,20464,1.0,0
object_zg,True,4608,4608,1.0,0
object_gi_hoverboots,True,7792,7792,1.0,0
object_gi_m_arrow,True,3712,3712,1.0,0
object_ds2,True,17008,17008,1.0,0
object_ec,True,51504,51504,1.0,0
object_fish,True,87536,87536,1.0,0
object_gi_sutaru,True,1616,1616,1.0,0
object_gi_goddess,True,3152,3152,1.0,0
object_ssh,True,23552,23552,1.0,0
object_bigokuta,True,27600,27600,1.0,0
object_bg,True,29376,29376,1.0,0
object_spot05_objects,True,4848,4848,1.0,0
object_spot12_obj,True,9152,9152,1.0,0
object_bombiwa,True,2816,2816,1.0,0
object_hintnuts,True,12608,12608,1.0,0
object_rs,True,18560,18560,1.0,0
object_spot00_break,True,7712,7712,1.0,0
object_gla,True,40688,40688,1.0,0
object_shopnuts,True,17808,17808,1.0,0
object_geldb,True,46832,46832,1.0,0
object_gr,True,40080,40080,1.0,0
object_dog,True,29344,29344,1.0,0
object_jya_iron,True,9824,9824,1.0,0
object_jya_door,True,8832,8832,1.0,0
object_spot01_objects2,True,16,16,1.0,0
object_spot11_obj,True,6800,6800,1.0,0
object_kibako2,True,4288,4288,1.0,0
object_dns,True,14288,14288,1.0,0
object_dnk,True,11824,11824,1.0,0
object_gi_fire,True,4064,4064,1.0,0
object_gi_insect,True,3056,3056,1.0,0
object_gi_butterfly,True,3024,3024,1.0,0
object_gi_ghost,True,3504,3504,1.0,0
object_gi_soul,True,4016,4016,1.0,0
object_bowl,True,13552,13552,1.0,0
object_po_field,True,27200,27200,1.0,0
object_demo_kekkai,True,60688,60688,1.0,0
object_efc_doughnut,True,4176,4176,1.0,0
object_gi_dekupouch,True,4176,4176,1.0,0
object_ganon_anime1,True,48192,48192,1.0,0
object_ganon_anime2,True,66864,66864,1.0,0
object_ganon_anime3,True,83952,83952,1.0,0
object_gi_rupy,True,2048,2048,1.0,0
object_spot01_matoya,True,15504,15504,1.0,0
object_spot01_matoyab,True,8672,8672,1.0,0
object_po_composer,True,28576,28576,1.0,0
object_mu,True,44624,44624,1.0,0
object_wf,True,42240,42240,1.0,0
object_skb,True,18448,18448,1.0,0
object_gj,True,42784,42784,1.0,0
object_geff,True,4016,4016,1.0,0
object_haka_door,True,14704,14704,1.0,0
object_gs,True,2688,2688,1.0,0
object_ps,True,51456,51456,1.0,0
object_bwall,True,4432,4432,1.0,0
object_crow,True,4304,4304,1.0,0
object_cow,True,20144,20144,1.0,0
object_cob,True,8720,8720,1.0,0
object_gi_sword_1,True,3360,3360,1.0,0
object_door_killer,True,7136,7136,1.0,0
object_ouke_haka,True,2416,2416,1.0,0
object_timeblock,True,2912,2912,1.0,0
object_zl4,True,118304,118304,1.0,0
g_pn_01,True,10368,10368,1.0,0
g_pn_02,True,10368,10368,1.0,0
g_pn_03,True,10368,10368,1.0,0
g_pn_04,True,10368,10368,1.0,0
g_pn_05,True,10368,10368,1.0,0
g_pn_06,True,10368,10368,1.0,0
g_pn_07,True,10368,10368,1.0,0
g_pn_08,True,10368,10368,1.0,0
g_pn_09,True,10368,10368,1.0,0
g_pn_10,True,10368,10368,1.0,0
g_pn_11,True,10368,10368,1.0,0
g_pn_12,True,10368,10368,1.0,0
g_pn_13,True,10368,10368,1.0,0
g_pn_14,True,10368,10368,1.0,0
g_pn_15,True,10368,10368,1.0,0
g_pn_16,True,10368,10368,1.0,0
g_pn_17,True,10368,10368,1.0,0
g_pn_18,True,10368,10368,1.0,0
g_pn_19,True,10368,10368,1.0,0
g_pn_20,True,10368,10368,1.0,0
g_pn_21,True,10368,10368,1.0,0
g_pn_22,True,10368,10368,1.0,0
g_pn_23,True,10368,10368,1.0,0
g_pn_24,True,10368,10368,1.0,0
g_pn_25,True,10368,10368,1.0,0
g_pn_26,True,10368,10368,1.0,0
g_pn_27,True,10368,10368,1.0,0
g_pn_28,True,10368,10368,1.0,0
g_pn_29,True,10368,10368,1.0,0
g_pn_30,True,10368,10368,1.0,0
g_pn_31,True,10368,10368,1.0,0
g_pn_32,True,10368,10368,1.0,0
g_pn_33,True,10368,10368,1.0,0
g_pn_34,True,10368,10368,1.0,0
g_pn_35,True,10368,10368,1.0,0
g_pn_36,True,10368,10368,1.0,0
g_pn_37,True,10368,10368,1.0,0
g_pn_38,True,10368,10368,1.0,0
g_pn_39,True,10368,10368,1.0,0
g_pn_40,True,10368,10368,1.0,0
g_pn_41,True,10368,10368,1.0,0
g_pn_42,True,10368,10368,1.0,0
g_pn_43,True,10368,10368,1.0,0
g_pn_44,True,10368,10368,1.0,0
g_pn_45,True,10368,10368,1.0,0
g_pn_46,True,10368,10368,1.0,0
g_pn_47,True,10368,10368,1.0,0
g_pn_48,True,10368,10368,1.0,0
g_pn_49,True,10368,10368,1.0,0
g_pn_50,True,10368,10368,1.0,0
g_pn_51,True,10368,10368,1.0,0
g_pn_52,True,10368,10368,1.0,0
g_pn_53,True,10368,10368,1.0,0
g_pn_54,True,10368,10368,1.0,0
g_pn_55,True,10368,10368,1.0,0
g_pn_56,True,10368,10368,1.0,0
g_pn_57,True,10368,10368,1.0,0
z_select_static,True,8704,8704,1.0,0
nintendo_rogo_static,True,11712,11712,1.0,0
title_static,True,291904,291904,1.0,0
parameter_static,True,15104,15104,1.0,0
vr_fine0_static,True,49152,49152,1.0,0
vr_fine0_pal_static,True,256,256,1.0,0
vr_fine1_static,True,49152,49152,1.0,0
vr_fine1_pal_static,True,256,256,1.0,0
vr_fine2_static,True,49152,49152,1.0,0
vr_fine2_pal_static,True,256,256,1.0,0
vr_fine3_static,True,49152,49152,1.0,0
vr_fine3_pal_static,True,256,256,1.0,0
vr_cloud0_static,True,49152,49152,1.0,0
vr_cloud0_pal_static,True,256,256,1.0,0
vr_cloud1_static,True,49152,49152,1.0,0
vr_cloud1_pal_static,True,256,256,1.0,0
vr_cloud2_static,True,49152,49152,1.0,0
vr_cloud2_pal_static,True,256,256,1.0,0
vr_cloud3_static,True,49152,49152,1.0,0
vr_cloud3_pal_static,True,256,256,1.0,0
vr_holy0_static,True,65536,65536,1.0,0
vr_holy0_pal_static,True,256,256,1.0,0
vr_holy1_static,True,65536,65536,1.0,0
vr_holy1_pal_static,True,256,256,1.0,0
vr_MDVR_static,True,262144,262144,1.0,0
vr_MDVR_pal_static,True,2048,2048,1.0,0
vr_MNVR_static,True,262144,262144,1.0,0
vr_MNVR_pal_static,True,2048,2048,1.0,0
vr_RUVR_static,True,262144,262144,1.0,0
vr_RUVR_pal_static,True,2048,2048,1.0,0
vr_LHVR_static,True,262144,262144,1.0,0
vr_LHVR_pal_static,True,2048,2048,1.0,0
vr_KHVR_static,True,262144,262144,1.0,0
vr_KHVR_pal_static,True,2048,2048,1.0,0
vr_K3VR_static,True,196608,196608,1.0,0
vr_K3VR_pal_static,True,1536,1536,1.0,0
vr_K4VR_static,True,196608,196608,1.0,0
vr_K4VR_pal_static,True,1536,1536,1.0,0
vr_K5VR_static,True,196608,196608,1.0,0
vr_K5VR_pal_static,True,1536,1536,1.0,0
vr_SP1a_static,True,131072,131072,1.0,0
vr_SP1a_pal_static,True,1024,1024,1.0,0
vr_MLVR_static,True,262144,262144,1.0,0
vr_MLVR_pal_static,True,2048,2048,1.0,0
vr_KKRVR_static,True,262144,262144,1.0,0
vr_KKRVR_pal_static,True,2048,2048,1.0,0
vr_KR3VR_static,True,196608,196608,1.0,0
vr_KR3VR_pal_static,True,1536,1536,1.0,0
vr_IPVR_static,True,262144,262144,1.0,0
vr_IPVR_pal_static,True,2048,2048,1.0,0
vr_KSVR_static,True,131072,131072,1.0,0
vr_KSVR_pal_static,True,1024,1024,1.0,0
vr_GLVR_static,True,131072,131072,1.0,0
vr_GLVR_pal_static,True,1024,1024,1.0,0
vr_ZRVR_static,True,131072,131072,1.0,0
vr_ZRVR_pal_static,True,1024,1024,1.0,0
vr_DGVR_static,True,131072,131072,1.0,0
vr_DGVR_pal_static,True,1024,1024,1.0,0
vr_ALVR_static,True,131072,131072,1.0,0
vr_ALVR_pal_static,True,1024,1024,1.0,0
vr_NSVR_static,True,131072,131072,1.0,0
vr_NSVR_pal_static,True,1024,1024,1.0,0
vr_LBVR_static,True,262144,262144,1.0,0
vr_LBVR_pal_static,True,2048,2048,1.0,0
vr_TTVR_static,True,196608,196608,1.0,0
vr_TTVR_pal_static,True,1536,1536,1.0,0
vr_FCVR_static,True,131072,131072,1.0,0
vr_FCVR_pal_static,True,1024,1024,1.0,0
elf_message_field,True,112,112,1.0,0
elf_message_ydan,True,16,16,1.0,0
syotes_scene,,7168,,,
syotes_room_0,,53120,,,
syotes2_scene,,9392,,,
syotes2_room_0,,40704,,,
depth_test_scene,,768,,,
depth_test_room_0,,155376,,,
spot00_scene,False,172576,172576,1.0,0
spot00_room_0,True,86576,86576,1.0,0
spot01_scene,False,115024,115024,1.0,0
spot01_room_0,True,40672,40672,1.0,0
spot02_scene,False,48256,48256,1.0,0
spot02_room_0,True,9952,9952,1.0,0
spot02_room_1,True,122768,122768,1.0,0
spot03_scene,False,46432,46432,1.0,0
spot03_room_0,True,55680,55680,1.0,0
spot03_room_1,True,29952,29952,1.0,0
spot04_scene,False,70208,70208,1.0,0
spot04_room_0,True,111760,111760,1.0,0
spot04_room_1,True,34176,34176,1.0,0
spot04_room_2,True,20592,20592,1.0,0
spot05_scene,False,85344,85344,1.0,0
spot05_room_0,True,40704,40704,1.0,0
spot06_scene,False,111664,111664,1.0,0
spot06_room_0,True,42528,42528,1.0,0
spot07_scene,False,38944,38944,1.0,0
spot07_room_0,True,25328,25328,1.0,0
spot07_room_1,True,51616,51616,1.0,0
spot08_scene,False,71328,71328,1.0,0
spot08_room_0,True,33120,33120,1.0,0
spot09_scene,False,69984,69984,1.0,0
spot09_room_0,True,34752,34752,1.0,0
spot10_scene,False,66608,66608,1.0,0
spot10_room_0,True,9712,9712,1.0,0
spot10_room_1,True,33840,33840,1.0,0
spot10_room_2,True,19440,19440,1.0,0
spot10_room_3,True,23216,23216,1.0,0
spot10_room_4,True,9424,9424,1.0,0
spot10_room_5,True,28656,28656,1.0,0
spot10_room_6,True,15088,15088,1.0,0
spot10_room_7,True,9664,9664,1.0,0
spot10_room_8,True,9840,9840,1.0,0
spot10_room_9,True,15328,15328,1.0,0
spot11_scene,False,103648,103648,1.0,0
spot11_room_0,True,51136,51136,1.0,0
spot12_scene,False,65152,65152,1.0,0
spot12_room_0,True,71104,71104,1.0,0
spot12_room_1,True,49312,49312,1.0,0
spot13_scene,False,24112,24112,1.0,0
spot13_room_0,True,2320,2320,1.0,0
spot13_room_1,True,76352,76352,1.0,0
spot15_scene,False,99584,99584,1.0,0
spot15_room_0,True,53696,53696,1.0,0
spot16_scene,False,125584,125584,1.0,0
spot16_room_0,True,44304,44304,1.0,0
spot17_scene,False,65248,65248,1.0,0
spot17_room_0,True,26752,26752,1.0,0
spot17_room_1,True,74592,74592,1.0,0
spot18_scene,False,42064,42064,1.0,0
spot18_room_0,True,75728,75728,1.0,0
spot18_room_1,True,25088,25088,1.0,0
spot18_room_2,True,72112,72112,1.0,0
spot18_room_3,True,122096,122096,1.0,0
ydan_scene,False,55840,55840,1.0,0
ydan_room_0,True,86864,86864,1.0,0
ydan_room_1,True,16896,16896,1.0,0
ydan_room_2,True,24368,24368,1.0,0
ydan_room_3,True,82352,82352,1.0,0
ydan_room_4,True,19504,19504,1.0,0
ydan_room_5,True,33680,33680,1.0,0
ydan_room_6,True,20224,20224,1.0,0
ydan_room_7,True,35488,35488,1.0,0
ydan_room_8,True,3472,3472,1.0,0
ydan_room_9,True,39072,39072,1.0,0
ydan_room_10,True,19968,19968,1.0,0
ydan_room_11,True,29040,29040,1.0,0
ddan_scene,False,86336,86336,1.0,0
ddan_room_0,True,112800,112800,1.0,0
ddan_room_1,True,39792,39792,1.0,0
ddan_room_2,True,32448,32448,1.0,0
ddan_room_3,True,56944,56944,1.0,0
ddan_room_4,True,39264,39264,1.0,0
ddan_room_5,True,24256,24256,1.0,0
ddan_room_6,True,9392,9392,1.0,0
ddan_room_7,True,30464,30464,1.0,0
ddan_room_8,True,38304,38304,1.0,0
ddan_room_9,True,46384,46384,1.0,0
ddan_room_10,True,32528,32528,1.0,0
ddan_room_11,True,8240,8240,1.0,0
ddan_room_12,True,34688,34688,1.0,0
ddan_room_13,True,9424,9424,1.0,0
ddan_room_14,True,9424,9424,1.0,0
ddan_room_15,True,10544,10544,1.0,0
ddan_room_16,True,21856,21856,1.0,0
bdan_scene,False,88032,88032,1.0,0
bdan_room_0,True,16704,16704,1.0,0
bdan_room_1,True,24512,24512,1.0,0
bdan_room_2,False,37440,37440,1.0,0
bdan_room_3,True,29280,29280,1.0,0
bdan_room_4,True,16640,16640,1.0,0
bdan_room_5,True,24720,24720,1.0,0
bdan_room_6,True,16960,16960,1.0,0
bdan_room_7,True,13520,13520,1.0,0
bdan_room_8,False,14400,14400,1.0,0
bdan_room_9,False,15408,15408,1.0,0
bdan_room_10,False,14368,14368,1.0,0
bdan_room_11,False,14832,14832,1.0,0
bdan_room_12,False,15584,15584,1.0,0
bdan_room_13,True,11136,11136,1.0,0
bdan_room_14,True,25040,25040,1.0,0
bdan_room_15,True,9952,9952,1.0,0
Bmori1_scene,False,90000,90000,1.0,0
Bmori1_room_0,True,56208,56208,1.0,0
Bmori1_room_1,True,23408,23408,1.0,0
Bmori1_room_2,True,63872,63872,1.0,0
Bmori1_room_3,True,14816,14816,1.0,0
Bmori1_room_4,True,12992,12992,1.0,0
Bmori1_room_5,True,13776,13776,1.0,0
Bmori1_room_6,True,37936,37936,1.0,0
Bmori1_room_7,True,77792,77792,1.0,0
Bmori1_room_8,True,96944,96944,1.0,0
Bmori1_room_9,True,41312,41312,1.0,0
Bmori1_room_10,True,21472,21472,1.0,0
Bmori1_room_11,True,44000,44000,1.0,0
Bmori1_room_12,True,33760,33760,1.0,0
Bmori1_room_13,True,35504,35504,1.0,0
Bmori1_room_14,True,23408,23408,1.0,0
Bmori1_room_15,True,9952,9952,1.0,0
Bmori1_room_16,True,20384,20384,1.0,0
Bmori1_room_17,True,37104,37104,1.0,0
Bmori1_room_18,True,4912,4912,1.0,0
Bmori1_room_19,True,1280,1280,1.0,0
Bmori1_room_20,True,4864,4864,1.0,0
Bmori1_room_21,True,6000,6000,1.0,0
Bmori1_room_22,True,7648,7648,1.0,0
HIDAN_scene,False,108496,108496,1.0,0
HIDAN_room_0,True,29424,29424,1.0,0
HIDAN_room_1,True,51504,51504,1.0,0
HIDAN_room_2,True,65584,65584,1.0,0
HIDAN_room_3,True,9424,9424,1.0,0
HIDAN_room_4,True,30960,30960,1.0,0
HIDAN_room_5,True,41696,41696,1.0,0
HIDAN_room_6,True,28560,28560,1.0,0
HIDAN_room_7,True,14928,14928,1.0,0
HIDAN_room_8,True,39648,39648,1.0,0
HIDAN_room_9,True,34672,34672,1.0,0
HIDAN_room_10,True,99360,99360,1.0,0
HIDAN_room_11,True,14304,14304,1.0,0
HIDAN_room_12,True,11120,11120,1.0,0
HIDAN_room_13,True,52112,52112,1.0,0
HIDAN_room_14,True,8704,8704,1.0,0
HIDAN_room_15,True,4496,4496,1.0,0
HIDAN_room_16,True,47584,47584,1.0,0
HIDAN_room_17,True,37232,37232,1.0,0
HIDAN_room_18,True,15360,15360,1.0,0
HIDAN_room_19,True,16944,16944,1.0,0
HIDAN_room_20,True,27920,27920,1.0,0
HIDAN_room_21,True,33920,33920,1.0,0
HIDAN_room_22,True,27376,27376,1.0,0
HIDAN_room_23,True,27936,27936,1.0,0
HIDAN_room_24,True,21824,21824,1.0,0
HIDAN_room_25,True,27360,27360,1.0,0
HIDAN_room_26,True,26784,26784,1.0,0
MIZUsin_scene,False,89136,89136,1.0,0
MIZUsin_room_0,True,89136,89136,1.0,0
MIZUsin_room_1,True,41424,41424,1.0,0
MIZUsin_room_2,True,23696,23696,1.0,0
MIZUsin_room_3,True,26560,26560,1.0,0
MIZUsin_room_4,True,24608,24608,1.0,0
MIZUsin_room_5,True,42560,42560,1.0,0
MIZUsin_room_6,True,45824,45824,1.0,0
MIZUsin_room_7,True,21856,21856,1.0,0
MIZUsin_room_8,True,56704,56704,1.0,0
MIZUsin_room_9,True,32944,32944,1.0,0
MIZUsin_room_10,True,24688,24688,1.0,0
MIZUsin_room_11,True,18976,18976,1.0,0
MIZUsin_room_12,True,28208,28208,1.0,0
MIZUsin_room_13,True,2560,2560,1.0,0
MIZUsin_room_14,True,28288,28288,1.0,0
MIZUsin_room_15,True,29808,29808,1.0,0
MIZUsin_room_16,True,15152,15152,1.0,0
MIZUsin_room_17,True,35504,35504,1.0,0
MIZUsin_room_18,True,16640,16640,1.0,0
MIZUsin_room_19,True,14640,14640,1.0,0
MIZUsin_room_20,True,26688,26688,1.0,0
MIZUsin_room_21,True,29856,29856,1.0,0
MIZUsin_room_22,True,37104,37104,1.0,0
jyasinzou_scene,False,105248,105248,1.0,0
jyasinzou_room_0,True,69616,69616,1.0,0
jyasinzou_room_1,True,37712,37712,1.0,0
jyasinzou_room_2,True,23472,23472,1.0,0
jyasinzou_room_3,True,15312,15312,1.0,0
jyasinzou_room_4,True,29312,29312,1.0,0
jyasinzou_room_5,True,98320,98320,1.0,0
jyasinzou_room_6,True,18416,18416,1.0,0
jyasinzou_room_7,True,21776,21776,1.0,0
jyasinzou_room_8,True,32944,32944,1.0,0
jyasinzou_room_9,True,24016,24016,1.0,0
jyasinzou_room_10,True,33184,33184,1.0,0
jyasinzou_room_11,True,4112,4112,1.0,0
jyasinzou_room_12,True,8416,8416,1.0,0
jyasinzou_room_13,True,22704,22704,1.0,0
jyasinzou_room_14,True,19616,19616,1.0,0
jyasinzou_room_15,True,33952,33952,1.0,0
jyasinzou_room_16,True,25024,25024,1.0,0
jyasinzou_room_17,True,38480,38480,1.0,0
jyasinzou_room_18,True,23776,23776,1.0,0
jyasinzou_room_19,True,24016,24016,1.0,0
jyasinzou_room_20,True,33216,33216,1.0,0
jyasinzou_room_21,True,18016,18016,1.0,0
jyasinzou_room_22,True,12400,12400,1.0,0
jyasinzou_room_23,True,37392,37392,1.0,0
jyasinzou_room_24,True,25808,25808,1.0,0
jyasinzou_room_25,True,88992,88992,1.0,0
jyasinzou_room_26,True,51968,51968,1.0,0
jyasinzou_room_27,True,22288,22288,1.0,0
jyasinzou_room_28,True,35376,35376,1.0,0
HAKAdan_scene,False,99264,99264,1.0,0
HAKAdan_room_0,True,45392,45392,1.0,0
HAKAdan_room_1,True,6896,6896,1.0,0
HAKAdan_room_2,True,43488,43488,1.0,0
HAKAdan_room_3,True,10624,10624,1.0,0
HAKAdan_room_4,True,7264,7264,1.0,0
HAKAdan_room_5,True,23232,23232,1.0,0
HAKAdan_room_6,True,30192,30192,1.0,0
HAKAdan_room_7,True,6880,6880,1.0,0
HAKAdan_room_8,True,20640,20640,1.0,0
HAKAdan_room_9,True,52368,52368,1.0,0
HAKAdan_room_10,True,30704,30704,1.0,0
HAKAdan_room_11,True,15968,15968,1.0,0
HAKAdan_room_12,True,22352,22352,1.0,0
HAKAdan_room_13,True,4128,4128,1.0,0
HAKAdan_room_14,True,22784,22784,1.0,0
HAKAdan_room_15,True,29376,29376,1.0,0
HAKAdan_room_16,True,10544,10544,1.0,0
HAKAdan_room_17,True,11744,11744,1.0,0
HAKAdan_room_18,True,54032,54032,1.0,0
HAKAdan_room_19,True,11648,11648,1.0,0
HAKAdan_room_20,True,7744,7744,1.0,0
HAKAdan_room_21,True,46512,46512,1.0,0
HAKAdan_room_22,True,10672,10672,1.0,0
HAKAdanCH_scene,False,50576,50576,1.0,0
HAKAdanCH_room_0,True,87840,87840,1.0,0
HAKAdanCH_room_1,True,45360,45360,1.0,0
HAKAdanCH_room_2,True,12640,12640,1.0,0
HAKAdanCH_room_3,True,7360,7360,1.0,0
HAKAdanCH_room_4,True,9376,9376,1.0,0
HAKAdanCH_room_5,True,10640,10640,1.0,0
HAKAdanCH_room_6,True,11936,11936,1.0,0
ice_doukutu_scene,False,71360,71360,1.0,0
ice_doukutu_room_0,True,34432,34432,1.0,0
ice_doukutu_room_1,True,50480,50480,1.0,0
ice_doukutu_room_2,True,23296,23296,1.0,0
ice_doukutu_room_3,True,32912,32912,1.0,0
ice_doukutu_room_4,True,30288,30288,1.0,0
ice_doukutu_room_5,True,34944,34944,1.0,0
ice_doukutu_room_6,True,16816,16816,1.0,0
ice_doukutu_room_7,True,22768,22768,1.0,0
ice_doukutu_room_8,True,6432,6432,1.0,0
ice_doukutu_room_9,True,34448,34448,1.0,0
ice_doukutu_room_10,True,17376,17376,1.0,0
ice_doukutu_room_11,True,22608,22608,1.0,0
men_scene,False,70848,70848,1.0,0
men_room_0,True,65424,65424,1.0,0
men_room_1,True,37488,37488,1.0,0
men_room_2,True,20560,20560,1.0,0
men_room_3,True,31824,31824,1.0,0
men_room_4,True,41440,41440,1.0,0
men_room_5,True,20512,20512,1.0,0
men_room_6,True,32640,32640,1.0,0
men_room_7,True,33472,33472,1.0,0
men_room_8,True,33328,33328,1.0,0
men_room_9,True,14448,14448,1.0,0
men_room_10,True,23632,23632,1.0,0
ganontika_scene,False,137168,137168,1.0,0
ganontika_room_0,True,37392,37392,1.0,0
ganontika_room_1,True,117200,117200,1.0,0
ganontika_room_2,True,30688,30688,1.0,0
ganontika_room_3,True,39488,39488,1.0,0
ganontika_room_4,True,31888,31888,1.0,0
ganontika_room_5,True,29984,29984,1.0,0
ganontika_room_6,True,64608,64608,1.0,0
ganontika_room_7,True,31888,31888,1.0,0
ganontika_room_8,True,36896,36896,1.0,0
ganontika_room_9,True,47136,47136,1.0,0
ganontika_room_10,True,27584,27584,1.0,0
ganontika_room_11,True,26960,26960,1.0,0
ganontika_room_12,True,45680,45680,1.0,0
ganontika_room_13,True,32064,32064,1.0,0
ganontika_room_14,True,41424,41424,1.0,0
ganontika_room_15,True,32064,32064,1.0,0
ganontika_room_16,True,11824,11824,1.0,0
ganontika_room_17,True,34336,34336,1.0,0
ganontika_room_18,True,50912,50912,1.0,0
ganontika_room_19,True,32064,32064,1.0,0
market_day_scene,False,9840,9840,1.0,0
market_day_room_0,True,22640,22640,1.0,0
market_night_scene,False,9776,9776,1.0,0
market_night_room_0,True,22432,22432,1.0,0
testroom_scene,,16896,,,
testroom_room_0,,17920,,,
testroom_room_1,,9200,,,
testroom_room_2,,12928,,,
testroom_room_3,,14880,,,
testroom_room_4,,768,,,
kenjyanoma_scene,False,14576,14576,1.0,0
kenjyanoma_room_0,True,78096,78096,1.0,0
tokinoma_scene,False,75680,75680,1.0,0
tokinoma_room_0,True,94688,94688,1.0,0
tokinoma_room_1,True,28880,28880,1.0,0
sutaru_scene,,2992,,,
sutaru_room_0,,29424,,,
link_home_scene,False,7008,7008,1.0,0
link_home_room_0,True,162944,162944,1.0,0
kokiri_shop_scene,False,2432,2432,1.0,0
kokiri_shop_room_0,True,199824,199824,1.0,0
kokiri_home_scene,False,3264,3264,1.0,0
kokiri_home_room_0,True,179248,179248,1.0,0
kakusiana_scene,False,55328,55328,1.0,0
kakusiana_room_0,True,29344,29344,1.0,0
kakusiana_room_1,True,20880,20880,1.0,0
kakusiana_room_2,True,10432,10432,1.0,0
kakusiana_room_3,True,20784,20784,1.0,0
kakusiana_room_4,True,31072,31072,1.0,0
kakusiana_room_5,True,18144,18144,1.0,0
kakusiana_room_6,True,23152,23152,1.0,0
kakusiana_room_7,True,16336,16336,1.0,0
kakusiana_room_8,True,13872,13872,1.0,0
kakusiana_room_9,True,23248,23248,1.0,0
kakusiana_room_10,True,23088,23088,1.0,0
kakusiana_room_11,True,34480,34480,1.0,0
kakusiana_room_12,True,32336,32336,1.0,0
kakusiana_room_13,True,28368,28368,1.0,0
entra_scene,False,992,992,1.0,0
entra_room_0,True,154480,154480,1.0,0
moribossroom_scene,False,6400,6400,1.0,0
moribossroom_room_0,True,24256,24256,1.0,0
moribossroom_room_1,True,55984,55984,1.0,0
syatekijyou_scene,False,49856,49856,1.0,0
syatekijyou_room_0,True,30448,30448,1.0,0
shop1_scene,False,752,752,1.0,0
shop1_room_0,True,169904,169904,1.0,0
hairal_niwa_scene,False,70544,70544,1.0,0
hairal_niwa_room_0,True,43232,43232,1.0,0
ganon_tou_scene,False,19312,19312,1.0,0
ganon_tou_room_0,True,80624,80624,1.0,0
sasatest_scene,,11040,,,
sasatest_room_0,,13904,,,
market_alley_scene,False,4688,4688,1.0,0
market_alley_room_0,True,481024,481024,1.0,0
spot20_scene,False,73248,73248,1.0,0
spot20_room_0,True,26320,26320,1.0,0
market_ruins_scene,False,5680,5680,1.0,0
market_ruins_room_0,True,10272,10272,1.0,0
entra_n_scene,False,1072,1072,1.0,0
entra_n_room_0,True,154480,154480,1.0,0
enrui_scene,False,992,992,1.0,0
enrui_room_0,True,154464,154464,1.0,0
market_alley_n_scene,False,4848,4848,1.0,0
market_alley_n_room_0,True,481008,481008,1.0,0
hiral_demo_scene,False,15696,15696,1.0,0
hiral_demo_room_0,True,1600,1600,1.0,0
kokiri_home3_scene,False,6048,6048,1.0,0
kokiri_home3_room_0,True,222736,222736,1.0,0
malon_stable_scene,False,1648,1648,1.0,0
malon_stable_room_0,True,189008,189008,1.0,0
kakariko_scene,False,3744,3744,1.0,0
kakariko_room_0,True,176064,176064,1.0,0
bdan_boss_scene,False,3648,3648,1.0,0
bdan_boss_room_0,True,12320,12320,1.0,0
bdan_boss_room_1,False,20672,20672,1.0,0
FIRE_bs_scene,False,19456,19456,1.0,0
FIRE_bs_room_0,True,17008,17008,1.0,0
FIRE_bs_room_1,True,28640,28640,1.0,0
hut_scene,False,1296,1296,1.0,0
hut_room_0,True,169376,169376,1.0,0
daiyousei_izumi_scene,False,57344,57344,1.0,0
daiyousei_izumi_room_0,True,14608,14608,1.0,0
hakaana_scene,False,2704,2704,1.0,0
hakaana_room_0,True,30928,30928,1.0,0
yousei_izumi_tate_scene,False,34832,34832,1.0,0
yousei_izumi_tate_room_0,True,17104,17104,1.0,0
yousei_izumi_yoko_scene,False,52640,52640,1.0,0
yousei_izumi_yoko_room_0,True,16400,16400,1.0,0
golon_scene,False,928,928,1.0,0
golon_room_0,True,156112,156112,1.0,0
zoora_scene,False,912,912,1.0,0
zoora_room_0,True,156128,156128,1.0,0
drag_scene,False,1008,1008,1.0,0
drag_room_0,True,179808,179808,1.0,0
alley_shop_scene,False,1456,1456,1.0,0
alley_shop_room_0,True,158768,158768,1.0,0
night_shop_scene,False,1648,1648,1.0,0
night_shop_room_0,True,166240,166240,1.0,0
impa_scene,False,3344,3344,1.0,0
impa_room_0,True,159648,159648,1.0,0
labo_scene,False,3824,3824,1.0,0
labo_room_0,True,182000,182000,1.0,0
tent_scene,False,1664,1664,1.0,0
tent_room_0,True,210592,210592,1.0,0
nakaniwa_scene,False,14880,14880,1.0,0
nakaniwa_room_0,True,97984,97984,1.0,0
ddan_boss_scene,False,10336,10336,1.0,0
ddan_boss_room_0,True,20016,20016,1.0,0
ddan_boss_room_1,True,15840,15840,1.0,0
ydan_boss_scene,False,5952,5952,1.0,0
ydan_boss_room_0,True,28656,28656,1.0,0
ydan_boss_room_1,True,26608,26608,1.0,0
HAKAdan_bs_scene,False,10112,10112,1.0,0
HAKAdan_bs_room_0,True,10720,10720,1.0,0
HAKAdan_bs_room_1,True,24400,24400,1.0,0
MIZUsin_bs_scene,False,6752,6752,1.0,0
MIZUsin_bs_room_0,True,17520,17520,1.0,0
MIZUsin_bs_room_1,True,45808,45808,1.0,0
ganon_scene,False,67504,67504,1.0,0
ganon_room_0,True,32464,32464,1.0,0
ganon_room_1,True,30576,30576,1.0,0
ganon_room_2,True,30800,30800,1.0,0
ganon_room_3,True,30512,30512,1.0,0
ganon_room_4,True,37072,37072,1.0,0
ganon_room_5,True,35600,35600,1.0,0
ganon_room_6,True,39840,39840,1.0,0
ganon_room_7,True,42912,42912,1.0,0
ganon_room_8,True,27616,27616,1.0,0
ganon_room_9,True,22816,22816,1.0,0
ganon_boss_scene,False,31776,31776,1.0,0
ganon_boss_room_0,True,24192,24192,1.0,0
jyasinboss_scene,False,36080,36080,1.0,0
jyasinboss_room_0,True,4048,4048,1.0,0
jyasinboss_room_1,True,32320,32320,1.0,0
jyasinboss_room_2,True,15808,15808,1.0,0
jyasinboss_room_3,True,46848,46848,1.0,0
kokiri_home4_scene,False,6832,6832,1.0,0
kokiri_home4_room_0,True,231760,231760,1.0,0
kokiri_home5_scene,False,5136,5136,1.0,0
kokiri_home5_room_0,True,200544,200544,1.0,0
ganon_final_scene,False,74112,74112,1.0,0
ganon_final_room_0,True,52912,52912,1.0,0
kakariko3_scene,False,2112,2112,1.0,0
kakariko3_room_0,True,173440,173440,1.0,0
hairal_niwa2_scene,,11536,,,
hairal_niwa2_room_0,,97280,,,
hakasitarelay_scene,False,57968,57968,1.0,0
hakasitarelay_room_0,True,29376,29376,1.0,0
hakasitarelay_room_1,True,26400,26400,1.0,0
hakasitarelay_room_2,True,33968,33968,1.0,0
hakasitarelay_room_3,True,36064,36064,1.0,0
hakasitarelay_room_4,True,17536,17536,1.0,0
hakasitarelay_room_5,True,17488,17488,1.0,0
hakasitarelay_room_6,True,31408,31408,1.0,0
shrine_scene,False,5344,5344,1.0,0
shrine_room_0,True,338672,338672,1.0,0
turibori_scene,False,75488,75488,1.0,0
turibori_room_0,True,26464,26464,1.0,0
shrine_n_scene,False,5376,5376,1.0,0
shrine_n_room_0,True,338704,338704,1.0,0
shrine_r_scene,False,5264,5264,1.0,0
shrine_r_room_0,True,338672,338672,1.0,0
hakaana2_scene,False,53392,53392,1.0,0
hakaana2_room_0,True,26640,26640,1.0,0
gerudoway_scene,False,55584,55584,1.0,0
gerudoway_room_0,True,19776,19776,1.0,0
gerudoway_room_1,True,29360,29360,1.0,0
gerudoway_room_2,True,15952,15952,1.0,0
gerudoway_room_3,True,45840,45840,1.0,0
gerudoway_room_4,True,14624,14624,1.0,0
gerudoway_room_5,True,20032,20032,1.0,0
hairal_niwa_n_scene,False,37104,37104,1.0,0
hairal_niwa_n_room_0,True,13856,13856,1.0,0
bowling_scene,False,60192,60192,1.0,0
bowling_room_0,True,25056,25056,1.0,0
hakaana_ouke_scene,False,19168,19168,1.0,0
hakaana_ouke_room_0,True,43008,43008,1.0,0
hakaana_ouke_room_1,True,18432,18432,1.0,0
hakaana_ouke_room_2,True,24848,24848,1.0,0
hylia_labo_scene,False,69776,69776,1.0,0
hylia_labo_room_0,True,30160,30160,1.0,0
souko_scene,False,27664,27664,1.0,0
souko_room_0,True,38208,38208,1.0,0
souko_room_1,True,42032,42032,1.0,0
souko_room_2,True,33152,33152,1.0,0
miharigoya_scene,False,50512,50512,1.0,0
miharigoya_room_0,True,15792,15792,1.0,0
mahouya_scene,False,43552,43552,1.0,0
mahouya_room_0,True,27280,27280,1.0,0
takaraya_scene,False,29104,29104,1.0,0
takaraya_room_0,True,40384,40384,1.0,0
takaraya_room_1,True,8192,8192,1.0,0
takaraya_room_2,True,8240,8240,1.0,0
takaraya_room_3,True,10272,10272,1.0,0
takaraya_room_4,True,12320,12320,1.0,0
takaraya_room_5,True,12288,12288,1.0,0
takaraya_room_6,True,11008,11008,1.0,0
ganon_sonogo_scene,False,32528,32528,1.0,0
ganon_sonogo_room_0,True,32384,32384,1.0,0
ganon_sonogo_room_1,True,31664,31664,1.0,0
ganon_sonogo_room_2,True,36000,36000,1.0,0
ganon_sonogo_room_3,True,22080,22080,1.0,0
ganon_sonogo_room_4,True,36080,36080,1.0,0
ganon_demo_scene,False,36976,36976,1.0,0
ganon_demo_room_0,True,16720,16720,1.0,0
besitu_scene,,1200,,,
besitu_room_0,,21728,,,
face_shop_scene,False,880,880,1.0,0
face_shop_room_0,True,190016,190016,1.0,0
kinsuta_scene,False,5648,5648,1.0,0
kinsuta_room_0,True,57504,57504,1.0,0
ganontikasonogo_scene,False,19200,19200,1.0,0
ganontikasonogo_room_0,True,97152,97152,1.0,0
ganontikasonogo_room_1,True,40736,40736,1.0,0
test01_scene,,15904,,,
test01_room_0,,39152,,,
bump_texture_static,True,1024,1024,1.0,0
anime_model_1_static,True,16,16,1.0,0
anime_model_2_static,True,16,16,1.0,0
anime_model_3_static,True,16,16,1.0,0
anime_model_4_static,True,16,16,1.0,0
anime_model_5_static,True,16,16,1.0,0
anime_model_6_static,True,16,16,1.0,0
anime_texture_1_static,True,16,16,1.0,0
anime_texture_2_static,True,16,16,1.0,0
anime_texture_3_static,True,16,16,1.0,0
anime_texture_4_static,True,16,16,1.0,0
anime_texture_5_static,True,16,16,1.0,0
anime_texture_6_static,True,16,16,1.0,0
softsprite_matrix_static,True,64,64,1.0,0
