Index,File,Are equals,Size in baserom,Size in other_baserom,Size proportion,Size difference,Bytes different
0,makerom,False,4192,4192,1.0,0,13
1,boot,False,24848,73488,0.338,-48640,21473
2,dmadata,False,24416,24768,0.986,-352,17720
20,nes_font_static,False,17920,17920,1.0,0,93
21,nes_message_data_static,False,229504,229664,0.999,-160,214550
28,code,False,1057328,1290032,0.82,-232704,950330
29,ovl_title,False,2128,2960,0.719,-832,1932
30,ovl_select,False,11392,12384,0.92,-992,9712
31,ovl_opening,False,352,336,1.048,16,202
32,ovl_file_choose,False,60432,64192,0.941,-3760,50296
33,ovl_kaleido_scope,False,117184,125312,0.935,-8128,95708
34,ovl_player_actor,False,157456,157840,0.998,-384,136881
35,ovl_map_mark_data,False,27360,27360,1.0,0,10
36,ovl_En_Test,False,22704,22704,1.0,0,18932
37,ovl_Arms_Hook,False,3440,3600,0.956,-160,2887
38,ovl_Arrow_Fire,False,7904,8128,0.972,-224,6824
39,ovl_Arrow_Ice,False,7936,8160,0.973,-224,6868
40,ovl_Arrow_Light,False,7952,8176,0.973,-224,6701
41,ovl_Bg_Bdan_Objects,False,4816,4976,0.968,-160,4303
42,ovl_Bg_Bdan_Switch,False,5168,5440,0.95,-272,4414
43,ovl_Bg_Bom_Guard,False,544,640,0.85,-96,472
44,ovl_Bg_Bombwall,False,2240,2448,0.915,-208,1889
45,ovl_Bg_Bowl_Wall,False,2432,2688,0.905,-256,2105
46,ovl_Bg_Breakwall,False,3696,3792,0.975,-96,2978
47,ovl_Bg_Ddan_Jd,False,1616,1600,1.01,16,1355
48,ovl_Bg_Ddan_Kd,False,2288,2320,0.986,-32,1953
49,ovl_Bg_Dodoago,False,3392,3520,0.964,-128,2812
50,ovl_Bg_Dy_Yoseizo,False,11760,12528,0.939,-768,10761
51,ovl_Bg_Ganon_Otyuka,False,9792,10304,0.95,-512,8517
52,ovl_Bg_Gate_Shutter,False,1168,1376,0.849,-208,1037
53,ovl_Bg_Gjyo_Bridge,False,1264,1392,0.908,-128,937
54,ovl_Bg_Gnd_Darkmeiro,False,1984,2192,0.905,-208,1327
55,ovl_Bg_Gnd_Firemeiro,False,1360,1504,0.904,-144,1069
56,ovl_Bg_Gnd_Iceblock,False,4336,4512,0.961,-176,3630
57,ovl_Bg_Gnd_Nisekabe,False,368,368,1.0,0,201
58,ovl_Bg_Gnd_Soulmeiro,False,2144,2288,0.937,-144,1787
59,ovl_Bg_Haka,False,1728,1856,0.931,-128,1473
60,ovl_Bg_Haka_Gate,False,4240,4544,0.933,-304,3759
61,ovl_Bg_Haka_Huta,False,2720,2688,1.012,32,2184
62,ovl_Bg_Haka_Megane,False,1024,1008,1.016,16,785
63,ovl_Bg_Haka_MeganeBG,False,1728,1712,1.009,16,1445
64,ovl_Bg_Haka_Sgami,False,3104,3104,1.0,0,2134
65,ovl_Bg_Haka_Ship,False,2640,2976,0.887,-336,2321
66,ovl_Bg_Haka_Trap,False,5584,5552,1.006,32,4673
67,ovl_Bg_Haka_Tubo,False,2592,2736,0.947,-144,2169
68,ovl_Bg_Haka_Water,False,2048,2240,0.914,-192,1804
69,ovl_Bg_Haka_Zou,False,4592,4560,1.007,32,3811
70,ovl_Bg_Heavy_Block,False,6384,6672,0.957,-288,5494
71,ovl_Bg_Hidan_Curtain,False,2720,3200,0.85,-480,2414
72,ovl_Bg_Hidan_Dalm,False,2128,2112,1.008,16,1644
73,ovl_Bg_Hidan_Firewall,False,1888,2016,0.937,-128,1558
74,ovl_Bg_Hidan_Fslift,False,1232,1200,1.027,32,1034
75,ovl_Bg_Hidan_Fwbig,False,3296,3408,0.967,-112,2874
76,ovl_Bg_Hidan_Hamstep,False,3760,4336,0.867,-576,3269
77,ovl_Bg_Hidan_Hrock,False,2096,2096,1.0,0,1543
78,ovl_Bg_Hidan_Kousi,False,1424,1728,0.824,-304,1236
79,ovl_Bg_Hidan_Kowarerukabe,False,3808,4192,0.908,-384,3170
80,ovl_Bg_Hidan_Rock,False,4352,4480,0.971,-128,3732
81,ovl_Bg_Hidan_Rsekizou,False,3040,3264,0.931,-224,2489
82,ovl_Bg_Hidan_Sekizou,False,5200,5392,0.964,-192,3504
83,ovl_Bg_Hidan_Sima,False,3840,4080,0.941,-240,3302
84,ovl_Bg_Hidan_Syoku,False,1120,1104,1.014,16,914
85,ovl_Bg_Ice_Objects,False,3904,3888,1.004,16,3160
86,ovl_Bg_Ice_Shelter,False,4672,4992,0.936,-320,3892
87,ovl_Bg_Ice_Shutter,False,1136,1120,1.014,16,587
88,ovl_Bg_Ice_Turara,False,2096,2080,1.008,16,1702
89,ovl_Bg_Ingate,False,912,1056,0.864,-144,768
90,ovl_Bg_Jya_1flift,False,1680,1888,0.89,-208,1440
91,ovl_Bg_Jya_Amishutter,False,912,1056,0.864,-144,782
92,ovl_Bg_Jya_Bigmirror,False,2128,2752,0.773,-624,1744
93,ovl_Bg_Jya_Block,False,624,768,0.812,-144,551
94,ovl_Bg_Jya_Bombchuiwa,False,2880,3328,0.865,-448,2436
95,ovl_Bg_Jya_Bombiwa,False,1472,1872,0.786,-400,1266
96,ovl_Bg_Jya_Cobra,False,7488,8320,0.9,-832,6774
97,ovl_Bg_Jya_Goroiwa,False,1920,1872,1.026,48,1552
98,ovl_Bg_Jya_Haheniron,False,2032,2016,1.008,16,1260
99,ovl_Bg_Jya_Ironobj,False,3504,3744,0.936,-240,3011
100,ovl_Bg_Jya_Kanaami,False,944,1120,0.843,-176,812
101,ovl_Bg_Jya_Lift,False,1360,1424,0.955,-64,1135
102,ovl_Bg_Jya_Megami,False,4592,4880,0.941,-288,3790
103,ovl_Bg_Jya_Zurerukabe,False,1712,2096,0.817,-384,1531
104,ovl_Bg_Menkuri_Eye,False,1168,1328,0.88,-160,1007
105,ovl_Bg_Menkuri_Kaiten,False,400,384,1.042,16,293
106,ovl_Bg_Menkuri_Nisekabe,False,336,336,1.0,0,161
107,ovl_Bg_Mizu_Bwall,False,5328,6064,0.879,-736,4622
108,ovl_Bg_Mizu_Movebg,False,4480,4624,0.969,-144,3720
109,ovl_Bg_Mizu_Shutter,False,2048,2192,0.934,-144,1806
110,ovl_Bg_Mizu_Uzu,False,464,464,1.0,0,293
111,ovl_Bg_Mizu_Water,False,3280,3792,0.865,-512,2964
112,ovl_Bg_Mjin,False,1008,1088,0.926,-80,859
113,ovl_Bg_Mori_Bigst,False,2352,3136,0.75,-784,2098
114,ovl_Bg_Mori_Elevator,False,2800,3424,0.818,-624,2439
115,ovl_Bg_Mori_Hashigo,False,2240,2816,0.795,-576,1929
116,ovl_Bg_Mori_Hashira4,False,1408,1888,0.746,-480,1248
117,ovl_Bg_Mori_Hineri,False,3408,3696,0.922,-288,3033
118,ovl_Bg_Mori_Idomizu,False,1600,1920,0.833,-320,1381
119,ovl_Bg_Mori_Kaitenkabe,False,1648,1968,0.837,-320,1391
120,ovl_Bg_Mori_Rakkatenjo,False,2432,3232,0.752,-800,2185
121,ovl_Bg_Po_Event,False,7728,7824,0.988,-96,5046
122,ovl_Bg_Po_Syokudai,False,2416,2608,0.926,-192,2077
123,ovl_Bg_Pushbox,False,768,880,0.873,-112,651
124,ovl_Bg_Relay_Objects,False,1968,1936,1.017,32,1621
125,ovl_Bg_Spot00_Break,False,416,416,1.0,0,275
126,ovl_Bg_Spot00_Hanebasi,False,4368,4672,0.935,-304,3581
127,ovl_Bg_Spot01_Fusya,False,672,800,0.84,-128,581
128,ovl_Bg_Spot01_Idohashira,False,3072,3584,0.857,-512,2613
129,ovl_Bg_Spot01_Idomizu,False,800,928,0.862,-128,547
130,ovl_Bg_Spot01_Idosoko,False,528,704,0.75,-176,433
131,ovl_Bg_Spot01_Objects2,False,1216,1312,0.927,-96,859
132,ovl_Bg_Spot02_Objects,False,4960,5248,0.945,-288,4335
133,ovl_Bg_Spot03_Taki,False,2336,2448,0.954,-112,1322
134,ovl_Bg_Spot05_Soko,False,800,784,1.02,16,640
135,ovl_Bg_Spot06_Objects,False,5120,5296,0.967,-176,4314
136,ovl_Bg_Spot07_Taki,False,1520,1696,0.896,-176,1281
137,ovl_Bg_Spot08_Bakudankabe,False,1696,1680,1.01,16,711
138,ovl_Bg_Spot08_Iceblock,False,4160,4480,0.929,-320,3704
139,ovl_Bg_Spot09_Obj,False,1312,1696,0.774,-384,937
140,ovl_Bg_Spot11_Bakudankabe,False,1600,1648,0.971,-48,629
141,ovl_Bg_Spot11_Oasis,False,1840,1952,0.943,-112,1521
142,ovl_Bg_Spot12_Gate,False,1040,1168,0.89,-128,896
143,ovl_Bg_Spot12_Saku,False,1216,1344,0.905,-128,1056
144,ovl_Bg_Spot15_Rrbox,False,3552,3824,0.929,-272,3105
145,ovl_Bg_Spot15_Saku,False,832,992,0.839,-160,720
146,ovl_Bg_Spot16_Bombstone,False,5456,6160,0.886,-704,4663
147,ovl_Bg_Spot16_Doughnut,False,1472,1920,0.767,-448,1276
148,ovl_Bg_Spot17_Bakudankabe,False,1776,2112,0.841,-336,882
149,ovl_Bg_Spot17_Funen,False,592,784,0.755,-192,507
150,ovl_Bg_Spot18_Basket,False,4080,4208,0.97,-128,3305
151,ovl_Bg_Spot18_Futa,False,416,400,1.04,16,316
152,ovl_Bg_Spot18_Obj,False,2256,2752,0.82,-496,1996
153,ovl_Bg_Spot18_Shutter,False,1360,1344,1.012,16,1120
154,ovl_Bg_Sst_Floor,False,1376,1520,0.905,-144,1210
155,ovl_Bg_Toki_Hikari,False,3488,3904,0.893,-416,2878
156,ovl_Bg_Toki_Swd,False,5712,5824,0.981,-112,2682
157,ovl_Bg_Treemouth,False,5728,5856,0.978,-128,4046
158,ovl_Bg_Umajump,False,400,384,1.042,16,302
159,ovl_Bg_Vb_Sima,False,1824,1952,0.934,-128,1540
160,ovl_Bg_Ydan_Hasi,False,1968,2112,0.932,-144,1698
161,ovl_Bg_Ydan_Maruta,False,1760,1744,1.009,16,1373
162,ovl_Bg_Ydan_Sp,False,5920,6160,0.961,-240,5010
163,ovl_Bg_Zg,False,1104,1392,0.793,-288,808
164,ovl_Boss_Dodongo,False,39680,39984,0.992,-304,34632
165,ovl_Boss_Fd,False,29536,30896,0.956,-1360,25852
166,ovl_Boss_Fd2,False,15664,16896,0.927,-1232,13277
167,ovl_Boss_Ganon,False,139952,142160,0.984,-2208,124368
168,ovl_Boss_Ganon2,False,70480,72672,0.97,-2192,59605
169,ovl_Boss_Ganondrof,False,19856,21456,0.925,-1600,17006
170,ovl_Boss_Goma,False,24480,24816,0.986,-336,19484
171,ovl_Boss_Mo,False,47824,49088,0.974,-1264,38910
172,ovl_Boss_Sst,False,50576,50880,0.994,-304,44222
173,ovl_Boss_Tw,False,78160,80752,0.968,-2592,69095
174,ovl_Boss_Va,False,59536,60560,0.983,-1024,51553
175,ovl_Demo_6K,False,11616,12672,0.917,-1056,10481
176,ovl_Demo_Du,False,14304,14816,0.965,-512,11706
177,ovl_Demo_Ec,False,14432,15008,0.962,-576,11715
178,ovl_Demo_Effect,False,23456,25664,0.914,-2208,20750
179,ovl_Demo_Ext,False,2384,2736,0.871,-352,1995
180,ovl_Demo_Geff,False,2080,2800,0.743,-720,1865
181,ovl_Demo_Gj,False,15536,16192,0.959,-656,12800
182,ovl_Demo_Go,False,3408,3584,0.951,-176,2910
183,ovl_Demo_Gt,False,22032,23696,0.93,-1664,19205
184,ovl_Demo_Ik,False,5392,6368,0.847,-976,4589
185,ovl_Demo_Im,False,16240,17056,0.952,-816,13544
186,ovl_Demo_Kankyo,False,15520,16640,0.933,-1120,13211
187,ovl_Demo_Kekkai,False,4848,5264,0.921,-416,4225
188,ovl_Demo_Sa,False,11040,11728,0.941,-688,9129
189,ovl_Demo_Shd,False,9232,9360,0.986,-128,6064
190,ovl_Demo_Tre_Lgt,False,1808,2096,0.863,-288,986
191,ovl_Door_Ana,False,1648,1776,0.928,-128,1429
192,ovl_Door_Gerudo,False,1520,1648,0.922,-128,1281
193,ovl_Door_Killer,False,5488,5712,0.961,-224,4844
194,ovl_Door_Shutter,False,8896,9088,0.979,-192,7767
195,ovl_Door_Toki,False,352,352,1.0,0,213
196,ovl_Door_Warp1,False,17152,17696,0.969,-544,14608
197,ovl_Efc_Erupc,False,2800,3104,0.902,-304,2406
198,ovl_Eff_Dust,False,5072,5344,0.949,-272,4237
199,ovl_Effect_Ss_Blast,False,912,1024,0.891,-112,493
200,ovl_Effect_Ss_Bomb,False,1072,1184,0.905,-112,820
201,ovl_Effect_Ss_Bomb2,False,2304,2544,0.906,-240,1903
202,ovl_Effect_Ss_Bubble,False,1152,1296,0.889,-144,1007
203,ovl_Effect_Ss_D_Fire,False,1264,1360,0.929,-96,1057
204,ovl_Effect_Ss_Dead_Db,False,1248,1344,0.929,-96,865
205,ovl_Effect_Ss_Dead_Dd,False,1424,1584,0.899,-160,760
206,ovl_Effect_Ss_Dead_Ds,False,1152,1312,0.878,-160,798
207,ovl_Effect_Ss_Dead_Sound,False,320,384,0.833,-64,253
208,ovl_Effect_Ss_Dt_Bubble,False,1424,1568,0.908,-144,751
209,ovl_Effect_Ss_Dust,False,2112,2192,0.964,-80,1540
210,ovl_Effect_Ss_En_Fire,False,1872,2000,0.936,-128,1333
211,ovl_Effect_Ss_En_Ice,False,2240,2448,0.915,-208,1647
212,ovl_Effect_Ss_Extra,False,960,1120,0.857,-160,784
213,ovl_Effect_Ss_Fcircle,False,1200,1344,0.893,-144,865
214,ovl_Effect_Ss_Fhg_Flash,False,3968,4320,0.919,-352,2709
215,ovl_Effect_Ss_Fire_Tail,False,1792,1936,0.926,-144,1408
216,ovl_Effect_Ss_G_Fire,False,656,640,1.025,16,400
217,ovl_Effect_Ss_G_Magma,False,608,592,1.027,16,347
218,ovl_Effect_Ss_G_Magma2,False,1296,1472,0.88,-176,1100
219,ovl_Effect_Ss_G_Ripple,False,1376,1488,0.925,-112,1168
220,ovl_Effect_Ss_G_Spk,False,1456,1552,0.938,-96,978
221,ovl_Effect_Ss_G_Splash,False,1200,1200,1.0,0,536
222,ovl_Effect_Ss_Hahen,False,1600,1888,0.847,-288,1420
223,ovl_Effect_Ss_HitMark,False,1360,1456,0.934,-96,945
224,ovl_Effect_Ss_Ice_Piece,False,1088,1264,0.861,-176,690
225,ovl_Effect_Ss_Ice_Smoke,False,1248,1472,0.848,-224,1053
226,ovl_Effect_Ss_K_Fire,False,1088,1232,0.883,-144,754
227,ovl_Effect_Ss_Kakera,False,4240,4496,0.943,-256,3720
228,ovl_Effect_Ss_KiraKira,False,1648,1760,0.936,-112,1089
229,ovl_Effect_Ss_Lightning,False,1744,1856,0.94,-112,1329
230,ovl_Effect_Ss_Sibuki,False,1744,1840,0.948,-96,1206
231,ovl_Effect_Ss_Sibuki2,False,816,976,0.836,-160,637
232,ovl_Effect_Ss_Solder_Srch_Ball,False,432,416,1.038,16,220
233,ovl_Effect_Ss_Stick,False,928,1072,0.866,-144,582
234,ovl_Effect_Ss_Stone1,False,896,1056,0.848,-160,706
235,ovl_Elf_Msg,False,1520,3040,0.5,-1520,1322
236,ovl_Elf_Msg2,False,1136,2080,0.546,-944,977
237,ovl_En_Am,False,9216,9296,0.991,-80,7426
238,ovl_En_Ani,False,3440,3504,0.982,-64,2920
239,ovl_En_Anubice,False,4784,5248,0.912,-464,4242
240,ovl_En_Anubice_Fire,False,3520,3680,0.957,-160,1934
241,ovl_En_Anubice_Tag,False,720,976,0.738,-256,622
242,ovl_En_Arow_Trap,False,336,336,1.0,0,62
243,ovl_En_Arrow,False,5888,6112,0.963,-224,5022
244,ovl_En_Attack_Niw,False,4704,4688,1.003,16,3893
245,ovl_En_Ba,False,7888,8080,0.976,-192,6820
246,ovl_En_Bb,False,15584,15696,0.993,-112,13496
247,ovl_En_Bdfire,False,2976,3120,0.954,-144,2585
248,ovl_En_Bigokuta,False,11008,11328,0.972,-320,9673
249,ovl_En_Bili,False,8912,8976,0.993,-64,7444
250,ovl_En_Bird,False,1216,1200,1.013,16,1009
251,ovl_En_Blkobj,False,1376,1648,0.835,-272,1199
252,ovl_En_Bom,False,3792,3936,0.963,-144,3218
253,ovl_En_Bom_Bowl_Man,False,5440,6160,0.883,-720,4855
254,ovl_En_Bom_Bowl_Pit,False,2416,2544,0.95,-128,2075
255,ovl_En_Bom_Chu,False,5792,5936,0.976,-144,4775
256,ovl_En_Bombf,False,5264,5408,0.973,-144,4546
257,ovl_En_Boom,False,2256,2368,0.953,-112,1899
258,ovl_En_Box,False,6992,7488,0.934,-496,5528
259,ovl_En_Brob,False,4336,4336,1.0,0,2903
260,ovl_En_Bubble,False,5152,5232,0.985,-80,4243
261,ovl_En_Butte,False,5584,5744,0.972,-160,4799
262,ovl_En_Bw,False,13200,13312,0.992,-112,11247
263,ovl_En_Bx,False,2816,2992,0.941,-176,2442
264,ovl_En_Changer,False,2528,3872,0.653,-1344,2273
265,ovl_En_Clear_Tag,False,35696,36384,0.981,-688,27694
266,ovl_En_Cow,False,5216,5184,1.006,32,4180
267,ovl_En_Crow,False,5792,5744,1.008,48,4956
268,ovl_En_Cs,False,4656,4736,0.983,-80,3880
269,ovl_En_Daiku,False,5952,6128,0.971,-176,5008
270,ovl_En_Daiku_Kakariko,False,5056,5296,0.955,-240,4418
271,ovl_En_Dekubaba,False,15024,15760,0.953,-736,13274
272,ovl_En_Dekunuts,False,6144,6112,1.005,32,5150
273,ovl_En_Dh,False,6880,6976,0.986,-96,5830
274,ovl_En_Dha,False,4096,4080,1.004,16,3406
275,ovl_En_Diving_Game,False,6576,6880,0.956,-304,5719
276,ovl_En_Dns,False,5008,5520,0.907,-512,4195
277,ovl_En_Dnt_Demo,False,3360,4608,0.729,-1248,3022
278,ovl_En_Dnt_Jiji,False,5408,6112,0.885,-704,4830
279,ovl_En_Dnt_Nomal,False,11776,12544,0.939,-768,10718
280,ovl_En_Dodojr,False,7840,7824,1.002,16,5401
281,ovl_En_Dodongo,False,11680,11648,1.003,32,9588
282,ovl_En_Dog,False,4528,4608,0.983,-80,3283
283,ovl_En_Door,False,3648,3680,0.991,-32,3127
284,ovl_En_Ds,False,3104,3072,1.01,32,2451
285,ovl_En_Du,False,6800,6848,0.993,-48,5375
286,ovl_En_Dy_Extra,False,1440,1696,0.849,-256,1305
287,ovl_En_Eg,False,432,528,0.818,-96,339
288,ovl_En_Eiyer,False,7264,7312,0.993,-48,6240
289,ovl_En_Elf,False,18880,19184,0.984,-304,14840
290,ovl_En_Encount1,False,2912,4720,0.617,-1808,2637
291,ovl_En_Encount2,False,4656,5392,0.864,-736,4069
292,ovl_En_Ex_Item,False,4480,5488,0.816,-1008,4130
293,ovl_En_Ex_Ruppy,False,4288,4784,0.896,-496,3816
294,ovl_En_Fd,False,11424,11760,0.971,-336,8691
295,ovl_En_Fd_Fire,False,3344,3504,0.954,-160,2628
296,ovl_En_Fhg_Fire,False,9888,10688,0.925,-800,8835
297,ovl_En_Fire_Rock,False,4368,5200,0.84,-832,3929
298,ovl_En_Firefly,False,8560,8720,0.982,-160,7457
299,ovl_En_Fish,False,8464,8848,0.957,-384,7180
300,ovl_En_Floormas,False,13280,13456,0.987,-176,11470
301,ovl_En_Fr,False,10896,11888,0.917,-992,9787
302,ovl_En_Fu,False,3392,3456,0.981,-64,2778
303,ovl_En_Fw,False,6080,6176,0.984,-96,4407
304,ovl_En_Fz,False,8208,8448,0.972,-240,6715
305,ovl_En_G_Switch,False,6176,7840,0.788,-1664,5617
306,ovl_En_Ganon_Mant,False,16944,17056,0.993,-112,9187
307,ovl_En_Ganon_Organ,False,28736,29056,0.989,-320,18157
308,ovl_En_Gb,False,5936,6128,0.969,-192,4987
309,ovl_En_Ge1,False,8240,8800,0.936,-560,6901
310,ovl_En_Ge2,False,6560,6736,0.974,-176,5232
311,ovl_En_Ge3,False,3136,3312,0.947,-176,2651
312,ovl_En_GeldB,False,21424,21568,0.993,-144,18574
313,ovl_En_GirlA,False,10528,12176,0.865,-1648,9062
314,ovl_En_Gm,False,3376,3728,0.906,-352,3025
315,ovl_En_Go,False,17984,18368,0.979,-384,15098
316,ovl_En_Go2,False,24640,24976,0.987,-336,20108
317,ovl_En_Goma,False,11440,11744,0.974,-304,8942
318,ovl_En_Goroiwa,False,9152,9856,0.929,-704,7901
319,ovl_En_Gs,False,7792,7936,0.982,-144,5425
320,ovl_En_Guest,False,2464,2864,0.86,-400,2236
321,ovl_En_Hata,False,1424,1408,1.011,16,942
322,ovl_En_Heishi1,False,5392,7120,0.757,-1728,4939
323,ovl_En_Heishi2,False,8704,10144,0.858,-1440,7972
324,ovl_En_Heishi3,False,2512,2704,0.929,-192,2057
325,ovl_En_Heishi4,False,3840,4400,0.873,-560,3465
326,ovl_En_Hintnuts,False,6704,6672,1.005,32,5752
327,ovl_En_Holl,False,4048,4128,0.981,-80,3387
328,ovl_En_Honotrap,False,5472,5824,0.94,-352,4288
329,ovl_En_Horse,False,49760,49760,1.0,0,42760
330,ovl_En_Horse_Game_Check,False,4304,4368,0.985,-64,3379
331,ovl_En_Horse_Ganon,False,3456,3440,1.005,16,2846
332,ovl_En_Horse_Link_Child,False,7680,7808,0.984,-128,6261
333,ovl_En_Horse_Normal,False,9760,9856,0.99,-96,7880
334,ovl_En_Horse_Zelda,False,2800,2768,1.012,32,2328
335,ovl_En_Hs,False,2976,3072,0.969,-96,2513
336,ovl_En_Hs2,False,1504,1552,0.969,-48,1019
337,ovl_En_Hy,False,14656,14912,0.983,-256,11771
338,ovl_En_Ice_Hono,False,4592,4896,0.938,-304,4027
339,ovl_En_Ik,False,18000,19600,0.918,-1600,15521
340,ovl_En_In,False,11680,11888,0.983,-208,9437
341,ovl_En_Insect,False,9504,9792,0.971,-288,8299
342,ovl_En_Ishi,False,37200,37408,0.994,-208,5293
343,ovl_En_It,False,400,384,1.042,16,189
344,ovl_En_Jj,False,5584,5648,0.989,-64,3541
345,ovl_En_Js,False,2512,2448,1.026,64,2095
346,ovl_En_Jsjutan,False,19920,20080,0.992,-160,12257
347,ovl_En_Kakasi,False,3392,3744,0.906,-352,3046
348,ovl_En_Kakasi2,False,1824,3344,0.545,-1520,1636
349,ovl_En_Kakasi3,False,4320,4736,0.912,-416,3894
350,ovl_En_Kanban,False,12624,13232,0.954,-608,8454
351,ovl_En_Karebaba,False,6384,6752,0.945,-368,5597
352,ovl_En_Ko,False,16704,16880,0.99,-176,13571
353,ovl_En_Kusa,False,5344,5552,0.963,-208,4609
354,ovl_En_Kz,False,5536,5616,0.986,-80,4640
355,ovl_En_Light,False,3584,3728,0.961,-144,1520
356,ovl_En_Lightbox,False,1152,1136,1.014,16,762
357,ovl_En_M_Fire1,False,416,416,1.0,0,186
358,ovl_En_M_Thunder,False,5632,5808,0.97,-176,4929
359,ovl_En_Ma1,False,4832,4880,0.99,-48,3538
360,ovl_En_Ma2,False,4192,4352,0.963,-160,3498
361,ovl_En_Ma3,False,4016,4192,0.958,-176,3567
362,ovl_En_Mag,False,9504,9552,0.995,-48,7955
363,ovl_En_Mb,False,16944,16896,1.003,48,14486
364,ovl_En_Md,False,9840,9904,0.994,-64,8171
365,ovl_En_Mk,False,3728,3696,1.009,32,3001
366,ovl_En_Mm,False,5728,5856,0.978,-128,4833
367,ovl_En_Mm2,False,3520,3792,0.928,-272,3032
368,ovl_En_Ms,False,1776,1792,0.991,-16,1376
369,ovl_En_Mu,False,2336,2416,0.967,-80,1941
370,ovl_En_Nb,False,17872,18928,0.944,-1056,15053
371,ovl_En_Niw,False,13104,14336,0.914,-1232,11909
372,ovl_En_Niw_Girl,False,2768,3264,0.848,-496,2517
373,ovl_En_Niw_Lady,False,6400,7696,0.832,-1296,5828
374,ovl_En_Nutsball,False,1568,1680,0.933,-112,1235
375,ovl_En_Nwc,False,2592,2768,0.936,-176,2178
376,ovl_En_Ny,False,6464,6896,0.937,-432,5548
377,ovl_En_OE2,False,224,192,1.167,32,131
378,ovl_En_Okarina_Effect,False,960,1472,0.652,-512,843
379,ovl_En_Okarina_Tag,False,5376,6464,0.832,-1088,4485
380,ovl_En_Okuta,False,9696,9792,0.99,-96,8404
381,ovl_En_Ossan,False,26080,29312,0.89,-3232,23622
382,ovl_En_Owl,False,15264,16048,0.951,-784,13623
383,ovl_En_Part,False,5728,5840,0.981,-112,3977
384,ovl_En_Peehat,False,14080,14352,0.981,-272,12096
385,ovl_En_Po_Desert,False,3520,3664,0.961,-144,2812
386,ovl_En_Po_Field,False,14848,15280,0.972,-432,12340
387,ovl_En_Po_Relay,False,5904,6224,0.949,-320,5221
388,ovl_En_Po_Sisters,False,19696,19904,0.99,-208,17018
389,ovl_En_Poh,False,16880,17264,0.978,-384,14959
390,ovl_En_Pu_box,False,832,832,1.0,0,401
391,ovl_En_Rd,False,10432,10448,0.998,-16,8668
392,ovl_En_Reeba,False,6768,7264,0.932,-496,5944
393,ovl_En_River_Sound,False,2448,2432,1.007,16,1830
394,ovl_En_Rl,False,3808,4496,0.847,-688,3345
395,ovl_En_Rr,False,9520,10192,0.934,-672,8221
396,ovl_En_Ru1,False,30368,31040,0.978,-672,24984
397,ovl_En_Ru2,False,11648,12304,0.947,-656,9315
398,ovl_En_Sa,False,8816,8848,0.996,-32,6661
399,ovl_En_Sb,False,5184,5248,0.988,-64,3895
400,ovl_En_Scene_Change,False,304,432,0.704,-128,254
401,ovl_En_Sda,False,5680,6208,0.915,-528,4942
402,ovl_En_Shopnuts,False,3856,3952,0.976,-96,3133
403,ovl_En_Si,False,1280,1264,1.013,16,947
404,ovl_En_Siofuki,False,3504,3616,0.969,-112,3071
405,ovl_En_Skb,False,6384,6416,0.995,-32,5438
406,ovl_En_Skj,False,14656,15344,0.955,-688,12410
407,ovl_En_Skjneedle,False,784,960,0.817,-176,669
408,ovl_En_Ssh,False,9712,9760,0.995,-48,7716
409,ovl_En_St,False,11376,11440,0.994,-64,9356
410,ovl_En_Sth,False,16576,16992,0.976,-416,13152
411,ovl_En_Stream,False,1424,1552,0.918,-128,1212
412,ovl_En_Sw,False,14192,14464,0.981,-272,12050
413,ovl_En_Syateki_Itm,False,3488,4544,0.768,-1056,2940
414,ovl_En_Syateki_Man,False,3520,4224,0.833,-704,3147
415,ovl_En_Syateki_Niw,False,8336,8624,0.967,-288,7288
416,ovl_En_Ta,False,14784,15040,0.983,-256,12811
417,ovl_En_Takara_Man,False,2240,2512,0.892,-272,2018
418,ovl_En_Tana,False,688,1072,0.642,-384,607
419,ovl_En_Tg,False,1760,1824,0.965,-64,1440
420,ovl_En_Tite,False,11680,11904,0.981,-224,10036
421,ovl_En_Tk,False,7728,8080,0.956,-352,6467
422,ovl_En_Torch,False,240,240,1.0,0,39
423,ovl_En_Torch2,False,10080,10160,0.992,-80,8278
424,ovl_En_Toryo,False,3216,3184,1.01,32,2515
425,ovl_En_Tp,False,7792,7952,0.98,-160,6685
426,ovl_En_Tr,False,6400,6512,0.983,-112,5536
427,ovl_En_Trap,False,4768,4752,1.003,16,4003
428,ovl_En_Tubo_Trap,False,3232,3520,0.918,-288,2812
429,ovl_En_Vali,False,9920,10240,0.969,-320,8464
430,ovl_En_Vase,False,256,240,1.067,16,172
431,ovl_En_Vb_Ball,False,4528,4704,0.963,-176,3590
432,ovl_En_Viewer,False,11936,12864,0.928,-928,10625
433,ovl_En_Vm,False,6336,6544,0.968,-208,5337
434,ovl_En_Wall_Tubo,False,1264,1840,0.687,-576,1099
435,ovl_En_Wallmas,False,6672,6912,0.965,-240,5754
436,ovl_En_Weather_Tag,False,3824,4720,0.81,-896,3332
437,ovl_En_Weiyer,False,6656,6688,0.995,-32,5841
438,ovl_En_Wf,False,17168,17328,0.991,-160,13658
439,ovl_En_Wonder_Item,False,3152,4016,0.785,-864,2788
440,ovl_En_Wonder_Talk,False,1680,3552,0.473,-1872,1532
441,ovl_En_Wonder_Talk2,False,1696,4256,0.398,-2560,1546
442,ovl_En_Wood02,False,4560,4704,0.969,-144,3775
443,ovl_En_Xc,False,26464,27568,0.96,-1104,22495
444,ovl_En_Yabusame_Mark,False,1744,3072,0.568,-1328,1571
445,ovl_En_Yukabyun,False,1552,1680,0.924,-128,1331
446,ovl_En_Zf,False,27360,27360,1.0,0,23080
447,ovl_En_Zl1,False,15888,15952,0.996,-64,8120
448,ovl_En_Zl2,False,18176,18976,0.958,-800,15393
449,ovl_En_Zl3,False,32336,33792,0.957,-1456,27716
450,ovl_En_Zl4,False,18992,19056,0.997,-64,13128
451,ovl_En_Zo,False,9664,10144,0.953,-480,7504
452,ovl_En_fHG,False,10544,11616,0.908,-1072,9654
453,ovl_End_Title,False,16672,17024,0.979,-352,12441
454,ovl_Fishing,False,80544,83664,0.963,-3120,71661
455,ovl_Item_B_Heart,False,1040,1184,0.878,-144,900
456,ovl_Item_Etcetera,False,2256,2544,0.887,-288,1969
457,ovl_Item_Inbox,False,352,336,1.048,16,226
458,ovl_Item_Ocarina,False,2000,2032,0.984,-32,1725
459,ovl_Item_Shield,False,2576,2736,0.942,-160,2141
460,ovl_Magic_Dark,False,6224,6560,0.949,-336,5294
461,ovl_Magic_Fire,False,8960,9104,0.984,-144,7717
462,ovl_Magic_Wind,False,7424,8016,0.926,-592,6723
463,ovl_Mir_Ray,False,6320,6704,0.943,-384,5424
464,ovl_Obj_Bean,False,10128,10720,0.945,-592,8891
465,ovl_Obj_Blockstop,False,416,400,1.04,16,292
466,ovl_Obj_Bombiwa,False,1392,1392,1.0,0,947
467,ovl_Obj_Comb,False,2144,2240,0.957,-96,1654
468,ovl_Obj_Dekujr,False,1600,1760,0.909,-160,1202
469,ovl_Obj_Elevator,False,960,1168,0.822,-208,842
470,ovl_Obj_Hamishi,False,2128,2256,0.943,-128,1265
471,ovl_Obj_Hana,False,784,768,1.021,16,586
472,ovl_Obj_Hsblock,False,1488,1792,0.83,-304,1278
473,ovl_Obj_Ice_Poly,False,2480,2624,0.945,-144,843
474,ovl_Obj_Kibako,False,3328,3376,0.986,-48,2606
475,ovl_Obj_Kibako2,False,1728,1792,0.964,-64,920
476,ovl_Obj_Lift,False,2592,2768,0.936,-176,2252
477,ovl_Obj_Lightswitch,False,5168,5840,0.885,-672,3575
478,ovl_Obj_Makekinsuta,False,336,672,0.5,-336,294
479,ovl_Obj_Makeoshihiki,False,1168,1424,0.82,-256,795
480,ovl_Obj_Mure,False,4112,5280,0.779,-1168,3622
481,ovl_Obj_Mure2,False,2592,2704,0.959,-112,2201
482,ovl_Obj_Mure3,False,2000,1968,1.016,32,1087
483,ovl_Obj_Oshihiki,False,6832,7760,0.88,-928,6096
484,ovl_Obj_Roomtimer,False,592,576,1.028,16,424
485,ovl_Obj_Switch,False,7648,8352,0.916,-704,6532
486,ovl_Obj_Syokudai,False,3136,3296,0.951,-160,2693
487,ovl_Obj_Timeblock,False,3152,3520,0.895,-368,2662
488,ovl_Obj_Tsubo,False,4080,4240,0.962,-160,3406
489,ovl_Obj_Warp2block,False,2864,3248,0.882,-384,2293
490,ovl_Object_Kankyo,False,12928,13776,0.938,-848,11276
491,ovl_Oceff_Spot,False,3888,4208,0.924,-320,3413
492,ovl_Oceff_Storm,False,7088,7344,0.965,-256,6421
493,ovl_Oceff_Wipe,False,3456,3616,0.956,-160,2781
494,ovl_Oceff_Wipe2,False,6000,6208,0.966,-208,5474
495,ovl_Oceff_Wipe3,False,5968,6176,0.966,-208,5577
496,ovl_Oceff_Wipe4,False,4064,4272,0.951,-208,3299
497,ovl_Shot_Sun,False,1728,1856,0.931,-128,1469
1013,spot00_scene,False,172576,172576,1.0,0,52
1015,spot01_scene,False,115024,115024,1.0,0,36
1017,spot02_scene,False,48256,48256,1.0,0,48
1020,spot03_scene,False,46432,46432,1.0,0,16
1023,spot04_scene,False,70208,70208,1.0,0,156
1027,spot05_scene,False,85344,85344,1.0,0,16
1029,spot06_scene,False,111664,111664,1.0,0,16
1031,spot07_scene,False,38944,38944,1.0,0,24
1034,spot08_scene,False,71328,71328,1.0,0,24
1036,spot09_scene,False,69984,69984,1.0,0,20
1038,spot10_scene,False,66608,66608,1.0,0,120
1049,spot11_scene,False,103648,103648,1.0,0,16
1051,spot12_scene,False,65152,65152,1.0,0,48
1054,spot13_scene,False,24112,24112,1.0,0,8
1057,spot15_scene,False,99584,99584,1.0,0,8
1059,spot16_scene,False,125584,125584,1.0,0,32
1061,spot17_scene,False,65248,65248,1.0,0,32
1064,spot18_scene,False,42064,42064,1.0,0,64
1069,ydan_scene,False,55840,55840,1.0,0,65
1082,ddan_scene,False,86336,86336,1.0,0,71
1100,bdan_scene,False,88032,88032,1.0,0,128
1103,bdan_room_2,False,37440,37440,1.0,0,24
1109,bdan_room_8,False,14400,14400,1.0,0,51
1110,bdan_room_9,False,15408,15408,1.0,0,51
1111,bdan_room_10,False,14368,14368,1.0,0,51
1112,bdan_room_11,False,14832,14832,1.0,0,51
1113,bdan_room_12,False,15584,15584,1.0,0,51
1117,Bmori1_scene,False,90000,90000,1.0,0,92
1141,HIDAN_scene,False,108496,108496,1.0,0,108
1169,MIZUsin_scene,False,89136,89136,1.0,0,92
1193,jyasinzou_scene,False,105248,105248,1.0,0,348
1223,HAKAdan_scene,False,99264,99264,1.0,0,92
1247,HAKAdanCH_scene,False,50576,50576,1.0,0,28
1255,ice_doukutu_scene,False,71360,71360,1.0,0,96
1268,men_scene,False,70848,70848,1.0,0,44
1280,ganontika_scene,False,137168,137168,1.0,0,80
1301,market_day_scene,False,9840,9840,1.0,0,4
1303,market_night_scene,False,9776,9776,1.0,0,4
1311,kenjyanoma_scene,False,14576,14576,1.0,0,16
1313,tokinoma_scene,False,75680,75680,1.0,0,96
1318,link_home_scene,False,7008,7008,1.0,0,12
1320,kokiri_shop_scene,False,2432,2432,1.0,0,4
1322,kokiri_home_scene,False,3264,3264,1.0,0,4
1324,kakusiana_scene,False,55328,55328,1.0,0,56
1339,entra_scene,False,992,992,1.0,0,4
1341,moribossroom_scene,False,6400,6400,1.0,0,8
1344,syatekijyou_scene,False,49856,49856,1.0,0,16
1346,shop1_scene,False,752,752,1.0,0,4
1348,hairal_niwa_scene,False,70544,70544,1.0,0,8
1350,ganon_tou_scene,False,19312,19312,1.0,0,12
1354,market_alley_scene,False,4688,4688,1.0,0,4
1356,spot20_scene,False,73248,73248,1.0,0,48
1358,market_ruins_scene,False,5680,5680,1.0,0,4
1360,entra_n_scene,False,1072,1072,1.0,0,4
1362,enrui_scene,False,992,992,1.0,0,4
1364,market_alley_n_scene,False,4848,4848,1.0,0,4
1366,hiral_demo_scene,False,15696,15696,1.0,0,52
1368,kokiri_home3_scene,False,6048,6048,1.0,0,4
1370,malon_stable_scene,False,1648,1648,1.0,0,4
1372,kakariko_scene,False,3744,3744,1.0,0,4
1374,bdan_boss_scene,False,3648,3648,1.0,0,8
1376,bdan_boss_room_1,False,20672,20672,1.0,0,24
1377,FIRE_bs_scene,False,19456,19456,1.0,0,8
1380,hut_scene,False,1296,1296,1.0,0,4
1382,daiyousei_izumi_scene,False,57344,57344,1.0,0,20
1384,hakaana_scene,False,2704,2704,1.0,0,4
1386,yousei_izumi_tate_scene,False,34832,34832,1.0,0,4
1388,yousei_izumi_yoko_scene,False,52640,52640,1.0,0,16
1390,golon_scene,False,928,928,1.0,0,4
1392,zoora_scene,False,912,912,1.0,0,4
1394,drag_scene,False,1008,1008,1.0,0,4
1396,alley_shop_scene,False,1456,1456,1.0,0,5
1398,night_shop_scene,False,1648,1648,1.0,0,6
1400,impa_scene,False,3344,3344,1.0,0,6
1402,labo_scene,False,3824,3824,1.0,0,6
1404,tent_scene,False,1664,1664,1.0,0,5
1406,nakaniwa_scene,False,14880,14880,1.0,0,16
1408,ddan_boss_scene,False,10336,10336,1.0,0,8
1411,ydan_boss_scene,False,5952,5952,1.0,0,8
1414,HAKAdan_bs_scene,False,10112,10112,1.0,0,8
1417,MIZUsin_bs_scene,False,6752,6752,1.0,0,8
1420,ganon_scene,False,67504,67504,1.0,0,40
1431,ganon_boss_scene,False,31776,31776,1.0,0,4
1433,jyasinboss_scene,False,36080,36080,1.0,0,64
1438,kokiri_home4_scene,False,6832,6832,1.0,0,4
1440,kokiri_home5_scene,False,5136,5136,1.0,0,4
1442,ganon_final_scene,False,74112,74112,1.0,0,4
1444,kakariko3_scene,False,2112,2112,1.0,0,4
1448,hakasitarelay_scene,False,57968,57968,1.0,0,28
1456,shrine_scene,False,5344,5344,1.0,0,4
1458,turibori_scene,False,75488,75488,1.0,0,4
1460,shrine_n_scene,False,5376,5376,1.0,0,4
1462,shrine_r_scene,False,5264,5264,1.0,0,4
1464,hakaana2_scene,False,53392,53392,1.0,0,4
1466,gerudoway_scene,False,55584,55584,1.0,0,24
1473,hairal_niwa_n_scene,False,37104,37104,1.0,0,4
1475,bowling_scene,False,60192,60192,1.0,0,4
1477,hakaana_ouke_scene,False,19168,19168,1.0,0,36
1481,hylia_labo_scene,False,69776,69776,1.0,0,4
1483,souko_scene,False,27664,27664,1.0,0,12
1487,miharigoya_scene,False,50512,50512,1.0,0,8
1489,mahouya_scene,False,43552,43552,1.0,0,4
1491,takaraya_scene,False,29104,29104,1.0,0,28
1499,ganon_sonogo_scene,False,32528,32528,1.0,0,20
1505,ganon_demo_scene,False,36976,36976,1.0,0,8
1509,face_shop_scene,False,880,880,1.0,0,4
1511,kinsuta_scene,False,5648,5648,1.0,0,4
1513,ganontikasonogo_scene,False,19200,19200,1.0,0,8
