Index,File,Are equals,Size in baserom,Size in other_baserom,Size proportion,Size difference,Bytes different
0,makerom,False,4192,4192,1.0,0,17
1,boot,False,26864,73488,0.366,-46624,23321
2,dmadata,False,24432,24768,0.986,-336,18060
3,Audiobank,True,179648,179648,1.0,0,0
4,Audioseq,False,326272,326272,1.0,0,6112
5,Audiotable,True,4526992,4526992,1.0,0,0
6,link_animetion,True,2513968,2513968,1.0,0,0
7,icon_item_static,False,564384,564384,1.0,0,1951
8,icon_item_24_static,True,46080,46080,1.0,0,0
9,icon_item_field_static,True,47408,47408,1.0,0,0
10,icon_item_dungeon_static,True,7552,7552,1.0,0,0
11,icon_item_gameover_static,True,15488,15488,1.0,0,0
12,icon_item_nes_static,True,56448,56448,1.0,0,0
13,icon_item_ger_static,True,60288,60288,1.0,0,0
14,icon_item_fra_static,True,62592,62592,1.0,0,0
15,item_name_static,True,377856,377856,1.0,0,0
16,map_name_static,True,205824,205824,1.0,0,0
17,do_action_static,True,33408,33408,1.0,0,0
18,message_static,True,16768,16768,1.0,0,0
19,message_texture_static,True,4608,4608,1.0,0,0
20,nes_font_static,False,17792,17920,0.993,-128,0
21,nes_message_data_static,True,229664,229664,1.0,0,0
22,ger_message_data_static,False,244128,244176,1.0,-48,221983
23,fra_message_data_static,False,226064,225728,1.001,336,211613
24,staff_message_data_static,True,3920,3920,1.0,0,0
25,map_grand_static,True,58192,58192,1.0,0,0
26,map_i_static,True,975120,975120,1.0,0,0
27,map_48x85_static,True,138720,138720,1.0,0,0
28,code,False,1053936,1290032,0.817,-236096,948758
29,ovl_title,False,2496,2960,0.843,-464,2224
30,ovl_select,False,11616,12384,0.938,-768,9492
31,ovl_opening,False,352,336,1.048,16,203
32,ovl_file_choose,False,67296,64192,1.048,3104,54137
33,ovl_kaleido_scope,False,117760,125312,0.94,-7552,95633
34,ovl_player_actor,False,157360,157840,0.997,-480,137078
35,ovl_map_mark_data,False,27488,27360,1.005,128,1145
36,ovl_En_Test,False,22704,22704,1.0,0,18930
37,ovl_Arms_Hook,False,3424,3600,0.951,-176,2863
38,ovl_Arrow_Fire,False,7872,8128,0.969,-256,6819
39,ovl_Arrow_Ice,False,7904,8160,0.969,-256,6841
40,ovl_Arrow_Light,False,7920,8176,0.969,-256,6721
41,ovl_Bg_Bdan_Objects,False,4816,4976,0.968,-160,4303
42,ovl_Bg_Bdan_Switch,False,5168,5440,0.95,-272,4418
43,ovl_Bg_Bom_Guard,False,544,640,0.85,-96,472
44,ovl_Bg_Bombwall,False,2240,2448,0.915,-208,1889
45,ovl_Bg_Bowl_Wall,False,2432,2688,0.905,-256,2105
46,ovl_Bg_Breakwall,False,3696,3792,0.975,-96,2974
47,ovl_Bg_Ddan_Jd,False,1616,1600,1.01,16,1355
48,ovl_Bg_Ddan_Kd,False,2288,2320,0.986,-32,1954
49,ovl_Bg_Dodoago,False,3392,3520,0.964,-128,2814
50,ovl_Bg_Dy_Yoseizo,False,11776,12528,0.94,-752,10765
51,ovl_Bg_Ganon_Otyuka,False,9792,10304,0.95,-512,8599
52,ovl_Bg_Gate_Shutter,False,1152,1376,0.837,-224,1026
53,ovl_Bg_Gjyo_Bridge,False,1280,1392,0.92,-112,1103
54,ovl_Bg_Gnd_Darkmeiro,False,1984,2192,0.905,-208,1326
55,ovl_Bg_Gnd_Firemeiro,False,1344,1504,0.894,-160,1055
56,ovl_Bg_Gnd_Iceblock,False,4336,4512,0.961,-176,3668
57,ovl_Bg_Gnd_Nisekabe,False,368,368,1.0,0,205
58,ovl_Bg_Gnd_Soulmeiro,False,2144,2288,0.937,-144,1795
59,ovl_Bg_Haka,False,1728,1856,0.931,-128,1475
60,ovl_Bg_Haka_Gate,False,4224,4544,0.93,-320,3724
61,ovl_Bg_Haka_Huta,False,2720,2688,1.012,32,2188
62,ovl_Bg_Haka_Megane,False,1024,1008,1.016,16,784
63,ovl_Bg_Haka_MeganeBG,False,1728,1712,1.009,16,1445
64,ovl_Bg_Haka_Sgami,False,3104,3104,1.0,0,2151
65,ovl_Bg_Haka_Ship,False,2624,2976,0.882,-352,2322
66,ovl_Bg_Haka_Trap,False,5584,5552,1.006,32,4678
67,ovl_Bg_Haka_Tubo,False,2592,2736,0.947,-144,2159
68,ovl_Bg_Haka_Water,False,2016,2240,0.9,-224,1799
69,ovl_Bg_Haka_Zou,False,4592,4560,1.007,32,3810
70,ovl_Bg_Heavy_Block,False,6384,6672,0.957,-288,5496
71,ovl_Bg_Hidan_Curtain,False,2720,3200,0.85,-480,2413
72,ovl_Bg_Hidan_Dalm,False,2128,2112,1.008,16,1646
73,ovl_Bg_Hidan_Firewall,False,1888,2016,0.937,-128,1549
74,ovl_Bg_Hidan_Fslift,False,1232,1200,1.027,32,1034
75,ovl_Bg_Hidan_Fwbig,False,3296,3408,0.967,-112,2857
76,ovl_Bg_Hidan_Hamstep,False,3760,4336,0.867,-576,3268
77,ovl_Bg_Hidan_Hrock,False,2096,2096,1.0,0,1549
78,ovl_Bg_Hidan_Kousi,False,1408,1728,0.815,-320,1229
79,ovl_Bg_Hidan_Kowarerukabe,False,3792,4192,0.905,-400,3171
80,ovl_Bg_Hidan_Rock,False,4336,4480,0.968,-144,3719
81,ovl_Bg_Hidan_Rsekizou,False,3040,3264,0.931,-224,2515
82,ovl_Bg_Hidan_Sekizou,False,5200,5392,0.964,-192,3597
83,ovl_Bg_Hidan_Sima,False,3872,4080,0.949,-208,3348
84,ovl_Bg_Hidan_Syoku,False,1120,1104,1.014,16,916
85,ovl_Bg_Ice_Objects,False,3904,3888,1.004,16,3164
86,ovl_Bg_Ice_Shelter,False,4656,4992,0.933,-336,3882
87,ovl_Bg_Ice_Shutter,False,1136,1120,1.014,16,589
88,ovl_Bg_Ice_Turara,False,2096,2080,1.008,16,1703
89,ovl_Bg_Ingate,False,912,1056,0.864,-144,779
90,ovl_Bg_Jya_1flift,False,1680,1888,0.89,-208,1440
91,ovl_Bg_Jya_Amishutter,False,912,1056,0.864,-144,781
92,ovl_Bg_Jya_Bigmirror,False,2112,2752,0.767,-640,1736
93,ovl_Bg_Jya_Block,False,624,768,0.812,-144,547
94,ovl_Bg_Jya_Bombchuiwa,False,2864,3328,0.861,-464,2418
95,ovl_Bg_Jya_Bombiwa,False,1472,1872,0.786,-400,1264
96,ovl_Bg_Jya_Cobra,False,7456,8320,0.896,-864,6757
97,ovl_Bg_Jya_Goroiwa,False,1920,1872,1.026,48,1553
98,ovl_Bg_Jya_Haheniron,False,2032,2016,1.008,16,1259
99,ovl_Bg_Jya_Ironobj,False,3504,3744,0.936,-240,3011
100,ovl_Bg_Jya_Kanaami,False,944,1120,0.843,-176,811
101,ovl_Bg_Jya_Lift,False,1360,1424,0.955,-64,1136
102,ovl_Bg_Jya_Megami,False,4576,4880,0.938,-304,3831
103,ovl_Bg_Jya_Zurerukabe,False,1712,2096,0.817,-384,1532
104,ovl_Bg_Menkuri_Eye,False,1168,1328,0.88,-160,1009
105,ovl_Bg_Menkuri_Kaiten,False,400,384,1.042,16,293
106,ovl_Bg_Menkuri_Nisekabe,False,336,336,1.0,0,165
107,ovl_Bg_Mizu_Bwall,False,5328,6064,0.879,-736,4638
108,ovl_Bg_Mizu_Movebg,False,4496,4624,0.972,-128,3726
109,ovl_Bg_Mizu_Shutter,False,2048,2192,0.934,-144,1801
110,ovl_Bg_Mizu_Uzu,False,464,464,1.0,0,297
111,ovl_Bg_Mizu_Water,False,3280,3792,0.865,-512,2964
112,ovl_Bg_Mjin,False,992,1088,0.912,-96,861
113,ovl_Bg_Mori_Bigst,False,2352,3136,0.75,-784,2102
114,ovl_Bg_Mori_Elevator,False,2800,3424,0.818,-624,2439
115,ovl_Bg_Mori_Hashigo,False,2240,2816,0.795,-576,1927
116,ovl_Bg_Mori_Hashira4,False,1408,1888,0.746,-480,1252
117,ovl_Bg_Mori_Hineri,False,3328,3696,0.9,-368,2953
118,ovl_Bg_Mori_Idomizu,False,1600,1920,0.833,-320,1370
119,ovl_Bg_Mori_Kaitenkabe,False,1632,1968,0.829,-336,1368
120,ovl_Bg_Mori_Rakkatenjo,False,2416,3232,0.748,-816,2173
121,ovl_Bg_Po_Event,False,7728,7824,0.988,-96,5075
122,ovl_Bg_Po_Syokudai,False,2384,2608,0.914,-224,2040
123,ovl_Bg_Pushbox,False,768,880,0.873,-112,650
124,ovl_Bg_Relay_Objects,False,1968,1936,1.017,32,1621
125,ovl_Bg_Spot00_Break,False,416,416,1.0,0,280
126,ovl_Bg_Spot00_Hanebasi,False,4368,4672,0.935,-304,3727
127,ovl_Bg_Spot01_Fusya,False,672,800,0.84,-128,579
128,ovl_Bg_Spot01_Idohashira,False,3072,3584,0.857,-512,2610
129,ovl_Bg_Spot01_Idomizu,False,784,928,0.845,-144,541
130,ovl_Bg_Spot01_Idosoko,False,528,704,0.75,-176,443
131,ovl_Bg_Spot01_Objects2,False,1216,1312,0.927,-96,855
132,ovl_Bg_Spot02_Objects,False,4944,5248,0.942,-304,4309
133,ovl_Bg_Spot03_Taki,False,2288,2448,0.935,-160,1366
134,ovl_Bg_Spot05_Soko,False,800,784,1.02,16,640
135,ovl_Bg_Spot06_Objects,False,5136,5296,0.97,-160,4269
136,ovl_Bg_Spot07_Taki,False,1488,1696,0.877,-208,1267
137,ovl_Bg_Spot08_Bakudankabe,False,1696,1680,1.01,16,710
138,ovl_Bg_Spot08_Iceblock,False,4160,4480,0.929,-320,3710
139,ovl_Bg_Spot09_Obj,False,1296,1696,0.764,-400,912
140,ovl_Bg_Spot11_Bakudankabe,False,1600,1648,0.971,-48,636
141,ovl_Bg_Spot11_Oasis,False,1840,1952,0.943,-112,1518
142,ovl_Bg_Spot12_Gate,False,1040,1168,0.89,-128,895
143,ovl_Bg_Spot12_Saku,False,1216,1344,0.905,-128,1055
144,ovl_Bg_Spot15_Rrbox,False,3552,3824,0.929,-272,3105
145,ovl_Bg_Spot15_Saku,False,832,992,0.839,-160,720
146,ovl_Bg_Spot16_Bombstone,False,5440,6160,0.883,-720,4656
147,ovl_Bg_Spot16_Doughnut,False,1456,1920,0.758,-464,1291
148,ovl_Bg_Spot17_Bakudankabe,False,1760,2112,0.833,-352,882
149,ovl_Bg_Spot17_Funen,False,592,784,0.755,-192,508
150,ovl_Bg_Spot18_Basket,False,4080,4208,0.97,-128,3305
151,ovl_Bg_Spot18_Futa,False,416,400,1.04,16,316
152,ovl_Bg_Spot18_Obj,False,2256,2752,0.82,-496,1999
153,ovl_Bg_Spot18_Shutter,False,1360,1344,1.012,16,1121
154,ovl_Bg_Sst_Floor,False,1376,1520,0.905,-144,1210
155,ovl_Bg_Toki_Hikari,False,3488,3904,0.893,-416,2896
156,ovl_Bg_Toki_Swd,False,5712,5824,0.981,-112,2683
157,ovl_Bg_Treemouth,False,5728,5856,0.978,-128,4046
158,ovl_Bg_Umajump,False,400,384,1.042,16,301
159,ovl_Bg_Vb_Sima,False,1808,1952,0.926,-144,1539
160,ovl_Bg_Ydan_Hasi,False,1968,2112,0.932,-144,1699
161,ovl_Bg_Ydan_Maruta,False,1760,1744,1.009,16,1372
162,ovl_Bg_Ydan_Sp,False,6000,6160,0.974,-160,5005
163,ovl_Bg_Zg,False,1136,1392,0.816,-256,1001
164,ovl_Boss_Dodongo,False,39648,39984,0.992,-336,34782
165,ovl_Boss_Fd,False,29488,30896,0.954,-1408,25772
166,ovl_Boss_Fd2,False,15664,16896,0.927,-1232,13259
167,ovl_Boss_Ganon,False,139872,142160,0.984,-2288,124290
168,ovl_Boss_Ganon2,False,70400,72672,0.969,-2272,60199
169,ovl_Boss_Ganondrof,False,19824,21456,0.924,-1632,17041
170,ovl_Boss_Goma,False,24448,24816,0.985,-368,19239
171,ovl_Boss_Mo,False,46496,49088,0.947,-2592,38245
172,ovl_Boss_Sst,False,50464,50880,0.992,-416,43851
173,ovl_Boss_Tw,False,77952,80752,0.965,-2800,69400
174,ovl_Boss_Va,False,59376,60560,0.98,-1184,51585
175,ovl_Demo_6K,False,11536,12672,0.91,-1136,10471
176,ovl_Demo_Du,False,14304,14816,0.965,-512,11705
177,ovl_Demo_Ec,False,14432,15008,0.962,-576,11815
178,ovl_Demo_Effect,False,23296,25664,0.908,-2368,20728
179,ovl_Demo_Ext,False,2368,2736,0.865,-368,1987
180,ovl_Demo_Geff,False,2080,2800,0.743,-720,1862
181,ovl_Demo_Gj,False,15536,16192,0.959,-656,12961
182,ovl_Demo_Go,False,3424,3584,0.955,-160,2923
183,ovl_Demo_Gt,False,22016,23696,0.929,-1680,19104
184,ovl_Demo_Ik,False,5392,6368,0.847,-976,4595
185,ovl_Demo_Im,False,16240,17056,0.952,-816,13547
186,ovl_Demo_Kankyo,False,15536,16640,0.934,-1104,13198
187,ovl_Demo_Kekkai,False,4832,5264,0.918,-432,4210
188,ovl_Demo_Sa,False,11040,11728,0.941,-688,9106
189,ovl_Demo_Shd,False,9232,9360,0.986,-128,6063
190,ovl_Demo_Tre_Lgt,False,1808,2096,0.863,-288,986
191,ovl_Door_Ana,False,1648,1776,0.928,-128,1428
192,ovl_Door_Gerudo,False,1520,1648,0.922,-128,1288
193,ovl_Door_Killer,False,5488,5712,0.961,-224,4844
194,ovl_Door_Shutter,False,8832,9088,0.972,-256,7667
195,ovl_Door_Toki,False,352,352,1.0,0,213
196,ovl_Door_Warp1,False,17056,17696,0.964,-640,14650
197,ovl_Efc_Erupc,False,2784,3104,0.897,-320,2384
198,ovl_Eff_Dust,False,5088,5344,0.952,-256,4222
199,ovl_Effect_Ss_Blast,False,912,1024,0.891,-112,493
200,ovl_Effect_Ss_Bomb,False,1056,1184,0.892,-128,801
201,ovl_Effect_Ss_Bomb2,False,2352,2544,0.925,-192,1939
202,ovl_Effect_Ss_Bubble,False,1152,1296,0.889,-144,1006
203,ovl_Effect_Ss_D_Fire,False,1264,1360,0.929,-96,1068
204,ovl_Effect_Ss_Dead_Db,False,1248,1344,0.929,-96,863
205,ovl_Effect_Ss_Dead_Dd,False,1424,1584,0.899,-160,757
206,ovl_Effect_Ss_Dead_Ds,False,1152,1312,0.878,-160,789
207,ovl_Effect_Ss_Dead_Sound,False,320,384,0.833,-64,253
208,ovl_Effect_Ss_Dt_Bubble,False,1424,1568,0.908,-144,751
209,ovl_Effect_Ss_Dust,False,2096,2192,0.956,-96,1562
210,ovl_Effect_Ss_En_Fire,False,1856,2000,0.928,-144,1323
211,ovl_Effect_Ss_En_Ice,False,2240,2448,0.915,-208,1655
212,ovl_Effect_Ss_Extra,False,960,1120,0.857,-160,785
213,ovl_Effect_Ss_Fcircle,False,1200,1344,0.893,-144,863
214,ovl_Effect_Ss_Fhg_Flash,False,3968,4320,0.919,-352,2709
215,ovl_Effect_Ss_Fire_Tail,False,1792,1936,0.926,-144,1409
216,ovl_Effect_Ss_G_Fire,False,656,640,1.025,16,400
217,ovl_Effect_Ss_G_Magma,False,608,592,1.027,16,347
218,ovl_Effect_Ss_G_Magma2,False,1296,1472,0.88,-176,1100
219,ovl_Effect_Ss_G_Ripple,False,1376,1488,0.925,-112,1168
220,ovl_Effect_Ss_G_Spk,False,1456,1552,0.938,-96,979
221,ovl_Effect_Ss_G_Splash,False,1200,1200,1.0,0,537
222,ovl_Effect_Ss_Hahen,False,1600,1888,0.847,-288,1419
223,ovl_Effect_Ss_HitMark,False,1360,1456,0.934,-96,938
224,ovl_Effect_Ss_Ice_Piece,False,1088,1264,0.861,-176,685
225,ovl_Effect_Ss_Ice_Smoke,False,1216,1472,0.826,-256,1032
226,ovl_Effect_Ss_K_Fire,False,1072,1232,0.87,-160,749
227,ovl_Effect_Ss_Kakera,False,4240,4496,0.943,-256,3721
228,ovl_Effect_Ss_KiraKira,False,1648,1760,0.936,-112,1090
229,ovl_Effect_Ss_Lightning,False,1744,1856,0.94,-112,1330
230,ovl_Effect_Ss_Sibuki,False,1744,1840,0.948,-96,1205
231,ovl_Effect_Ss_Sibuki2,False,816,976,0.836,-160,641
232,ovl_Effect_Ss_Solder_Srch_Ball,False,432,416,1.038,16,220
233,ovl_Effect_Ss_Stick,False,928,1072,0.866,-144,582
234,ovl_Effect_Ss_Stone1,False,912,1056,0.864,-144,715
235,ovl_Elf_Msg,False,1520,3040,0.5,-1520,1322
236,ovl_Elf_Msg2,False,1136,2080,0.546,-944,980
237,ovl_En_Am,False,9216,9296,0.991,-80,7430
238,ovl_En_Ani,False,3440,3504,0.982,-64,2921
239,ovl_En_Anubice,False,4784,5248,0.912,-464,4243
240,ovl_En_Anubice_Fire,False,3520,3680,0.957,-160,1946
241,ovl_En_Anubice_Tag,False,720,976,0.738,-256,621
242,ovl_En_Arow_Trap,False,336,336,1.0,0,62
243,ovl_En_Arrow,False,5872,6112,0.961,-240,5011
244,ovl_En_Attack_Niw,False,4704,4688,1.003,16,3893
245,ovl_En_Ba,False,7888,8080,0.976,-192,6857
246,ovl_En_Bb,False,15568,15696,0.992,-128,13441
247,ovl_En_Bdfire,False,2960,3120,0.949,-160,2592
248,ovl_En_Bigokuta,False,11024,11328,0.973,-304,9487
249,ovl_En_Bili,False,8912,8976,0.993,-64,7444
250,ovl_En_Bird,False,1216,1200,1.013,16,1009
251,ovl_En_Blkobj,False,1376,1648,0.835,-272,1193
252,ovl_En_Bom,False,3792,3936,0.963,-144,3230
253,ovl_En_Bom_Bowl_Man,False,5440,6160,0.883,-720,4855
254,ovl_En_Bom_Bowl_Pit,False,2416,2544,0.95,-128,2072
255,ovl_En_Bom_Chu,False,5792,5936,0.976,-144,4772
256,ovl_En_Bombf,False,5232,5408,0.967,-176,4534
257,ovl_En_Boom,False,2240,2368,0.946,-128,1714
258,ovl_En_Box,False,6960,7488,0.929,-528,5484
259,ovl_En_Brob,False,4336,4336,1.0,0,2905
260,ovl_En_Bubble,False,5152,5232,0.985,-80,4239
261,ovl_En_Butte,False,5584,5744,0.972,-160,4802
262,ovl_En_Bw,False,13168,13312,0.989,-144,11419
263,ovl_En_Bx,False,2800,2992,0.936,-192,2422
264,ovl_En_Changer,False,2528,3872,0.653,-1344,2273
265,ovl_En_Clear_Tag,False,35696,36384,0.981,-688,27683
266,ovl_En_Cow,False,5216,5184,1.006,32,4180
267,ovl_En_Crow,False,5792,5744,1.008,48,4958
268,ovl_En_Cs,False,4656,4736,0.983,-80,3891
269,ovl_En_Daiku,False,5952,6128,0.971,-176,5013
270,ovl_En_Daiku_Kakariko,False,5056,5296,0.955,-240,4422
271,ovl_En_Dekubaba,False,15008,15760,0.952,-752,13292
272,ovl_En_Dekunuts,False,6144,6112,1.005,32,5150
273,ovl_En_Dh,False,6864,6976,0.984,-112,5675
274,ovl_En_Dha,False,4096,4080,1.004,16,3406
275,ovl_En_Diving_Game,False,6576,6880,0.956,-304,5717
276,ovl_En_Dns,False,5008,5520,0.907,-512,4198
277,ovl_En_Dnt_Demo,False,3360,4608,0.729,-1248,3022
278,ovl_En_Dnt_Jiji,False,5392,6112,0.882,-720,4817
279,ovl_En_Dnt_Nomal,False,11840,12544,0.944,-704,10684
280,ovl_En_Dodojr,False,7840,7824,1.002,16,5400
281,ovl_En_Dodongo,False,11680,11648,1.003,32,9589
282,ovl_En_Dog,False,4528,4608,0.983,-80,3287
283,ovl_En_Door,False,3648,3680,0.991,-32,3127
284,ovl_En_Ds,False,3104,3072,1.01,32,2452
285,ovl_En_Du,False,6816,6848,0.995,-32,5612
286,ovl_En_Dy_Extra,False,1408,1696,0.83,-288,1272
287,ovl_En_Eg,False,432,528,0.818,-96,340
288,ovl_En_Eiyer,False,7264,7312,0.993,-48,6238
289,ovl_En_Elf,False,18880,19184,0.984,-304,14835
290,ovl_En_Encount1,False,2912,4720,0.617,-1808,2637
291,ovl_En_Encount2,False,4656,5392,0.864,-736,4061
292,ovl_En_Ex_Item,False,4464,5488,0.813,-1024,4113
293,ovl_En_Ex_Ruppy,False,4288,4784,0.896,-496,3818
294,ovl_En_Fd,False,11456,11760,0.974,-304,8888
295,ovl_En_Fd_Fire,False,3344,3504,0.954,-160,2615
296,ovl_En_Fhg_Fire,False,9760,10688,0.913,-928,8709
297,ovl_En_Fire_Rock,False,4368,5200,0.84,-832,3934
298,ovl_En_Firefly,False,8560,8720,0.982,-160,7462
299,ovl_En_Fish,False,8464,8848,0.957,-384,7180
300,ovl_En_Floormas,False,13280,13456,0.987,-176,11478
301,ovl_En_Fr,False,10896,11888,0.917,-992,9790
302,ovl_En_Fu,False,3392,3456,0.981,-64,2773
303,ovl_En_Fw,False,6064,6176,0.982,-112,4329
304,ovl_En_Fz,False,8208,8448,0.972,-240,6712
305,ovl_En_G_Switch,False,6192,7840,0.79,-1648,5618
306,ovl_En_Ganon_Mant,False,16928,17056,0.992,-128,9169
307,ovl_En_Ganon_Organ,False,28672,29056,0.987,-384,18406
308,ovl_En_Gb,False,5936,6128,0.969,-192,4999
309,ovl_En_Ge1,False,8240,8800,0.936,-560,6902
310,ovl_En_Ge2,False,6560,6736,0.974,-176,5239
311,ovl_En_Ge3,False,2896,3312,0.874,-416,2535
312,ovl_En_GeldB,False,21424,21568,0.993,-144,18581
313,ovl_En_GirlA,False,10528,12176,0.865,-1648,9065
314,ovl_En_Gm,False,3376,3728,0.906,-352,3033
315,ovl_En_Go,False,17984,18368,0.979,-384,15100
316,ovl_En_Go2,False,24608,24976,0.985,-368,20696
317,ovl_En_Goma,False,11408,11744,0.971,-336,8937
318,ovl_En_Goroiwa,False,9152,9856,0.929,-704,7900
319,ovl_En_Gs,False,7840,7936,0.988,-96,5219
320,ovl_En_Guest,False,2464,2864,0.86,-400,2236
321,ovl_En_Hata,False,1424,1408,1.011,16,941
322,ovl_En_Heishi1,False,5392,7120,0.757,-1728,4939
323,ovl_En_Heishi2,False,8704,10144,0.858,-1440,7970
324,ovl_En_Heishi3,False,2544,2704,0.941,-160,1454
325,ovl_En_Heishi4,False,3840,4400,0.873,-560,3463
326,ovl_En_Hintnuts,False,6704,6672,1.005,32,5752
327,ovl_En_Holl,False,4048,4128,0.981,-80,3402
328,ovl_En_Honotrap,False,5456,5824,0.937,-368,4286
329,ovl_En_Horse,False,49760,49760,1.0,0,42803
330,ovl_En_Horse_Game_Check,False,4304,4368,0.985,-64,3379
331,ovl_En_Horse_Ganon,False,3456,3440,1.005,16,2847
332,ovl_En_Horse_Link_Child,False,7680,7808,0.984,-128,6262
333,ovl_En_Horse_Normal,False,9760,9856,0.99,-96,7868
334,ovl_En_Horse_Zelda,False,2800,2768,1.012,32,2328
335,ovl_En_Hs,False,2976,3072,0.969,-96,2514
336,ovl_En_Hs2,False,1504,1552,0.969,-48,1020
337,ovl_En_Hy,False,14656,14912,0.983,-256,11776
338,ovl_En_Ice_Hono,False,4592,4896,0.938,-304,4028
339,ovl_En_Ik,False,17952,19600,0.916,-1648,15057
340,ovl_En_In,False,11680,11888,0.983,-208,9435
341,ovl_En_Insect,False,9504,9792,0.971,-288,8300
342,ovl_En_Ishi,False,37200,37408,0.994,-208,5298
343,ovl_En_It,False,400,384,1.042,16,190
344,ovl_En_Jj,False,5584,5648,0.989,-64,3545
345,ovl_En_Js,False,2512,2448,1.026,64,2096
346,ovl_En_Jsjutan,False,19904,20080,0.991,-176,11994
347,ovl_En_Kakasi,False,3392,3744,0.906,-352,3047
348,ovl_En_Kakasi2,False,1824,3344,0.545,-1520,1636
349,ovl_En_Kakasi3,False,4320,4736,0.912,-416,3892
350,ovl_En_Kanban,False,12624,13232,0.954,-608,8434
351,ovl_En_Karebaba,False,6384,6752,0.945,-368,5586
352,ovl_En_Ko,False,16704,16880,0.99,-176,13592
353,ovl_En_Kusa,False,5344,5552,0.963,-208,4608
354,ovl_En_Kz,False,5536,5616,0.986,-80,4642
355,ovl_En_Light,False,3568,3728,0.957,-160,1534
356,ovl_En_Lightbox,False,1152,1136,1.014,16,758
357,ovl_En_M_Fire1,False,416,416,1.0,0,187
358,ovl_En_M_Thunder,False,5616,5808,0.967,-192,4944
359,ovl_En_Ma1,False,4832,4880,0.99,-48,3541
360,ovl_En_Ma2,False,4192,4352,0.963,-160,3504
361,ovl_En_Ma3,False,4304,4192,1.027,112,3756
362,ovl_En_Mag,False,11104,9552,1.162,1552,8678
363,ovl_En_Mb,False,16912,16896,1.001,16,14029
364,ovl_En_Md,False,9840,9904,0.994,-64,8171
365,ovl_En_Mk,False,3728,3696,1.009,32,3001
366,ovl_En_Mm,False,5664,5856,0.967,-192,4814
367,ovl_En_Mm2,False,3520,3792,0.928,-272,3031
368,ovl_En_Ms,False,1776,1792,0.991,-16,1374
369,ovl_En_Mu,False,2336,2416,0.967,-80,1944
370,ovl_En_Nb,False,17872,18928,0.944,-1056,15071
371,ovl_En_Niw,False,13104,14336,0.914,-1232,11912
372,ovl_En_Niw_Girl,False,2768,3264,0.848,-496,2517
373,ovl_En_Niw_Lady,False,6400,7696,0.832,-1296,5830
374,ovl_En_Nutsball,False,1568,1680,0.933,-112,1233
375,ovl_En_Nwc,False,2624,2768,0.948,-144,2215
376,ovl_En_Ny,False,6448,6896,0.935,-448,5523
377,ovl_En_OE2,False,224,192,1.167,32,131
378,ovl_En_Okarina_Effect,False,960,1472,0.652,-512,844
379,ovl_En_Okarina_Tag,False,5376,6464,0.832,-1088,4484
380,ovl_En_Okuta,False,9696,9792,0.99,-96,8436
381,ovl_En_Ossan,False,26080,29312,0.89,-3232,23570
382,ovl_En_Owl,False,15264,16048,0.951,-784,13627
383,ovl_En_Part,False,5648,5840,0.967,-192,4831
384,ovl_En_Peehat,False,14080,14352,0.981,-272,12091
385,ovl_En_Po_Desert,False,3520,3664,0.961,-144,2862
386,ovl_En_Po_Field,False,14816,15280,0.97,-464,12345
387,ovl_En_Po_Relay,False,5904,6224,0.949,-320,5223
388,ovl_En_Po_Sisters,False,19696,19904,0.99,-208,17215
389,ovl_En_Poh,False,16784,17264,0.972,-480,14852
390,ovl_En_Pu_box,False,832,832,1.0,0,404
391,ovl_En_Rd,False,10416,10448,0.997,-32,8855
392,ovl_En_Reeba,False,6768,7264,0.932,-496,5942
393,ovl_En_River_Sound,False,2448,2432,1.007,16,1832
394,ovl_En_Rl,False,3808,4496,0.847,-688,3347
395,ovl_En_Rr,False,9520,10192,0.934,-672,8211
396,ovl_En_Ru1,False,30368,31040,0.978,-672,24962
397,ovl_En_Ru2,False,11648,12304,0.947,-656,9319
398,ovl_En_Sa,False,8816,8848,0.996,-32,6681
399,ovl_En_Sb,False,5184,5248,0.988,-64,3898
400,ovl_En_Scene_Change,False,304,432,0.704,-128,253
401,ovl_En_Sda,False,5696,6208,0.918,-512,4921
402,ovl_En_Shopnuts,False,3856,3952,0.976,-96,3132
403,ovl_En_Si,False,1280,1264,1.013,16,949
404,ovl_En_Siofuki,False,3504,3616,0.969,-112,3072
405,ovl_En_Skb,False,6384,6416,0.995,-32,5441
406,ovl_En_Skj,False,14640,15344,0.954,-704,12413
407,ovl_En_Skjneedle,False,784,960,0.817,-176,669
408,ovl_En_Ssh,False,9712,9760,0.995,-48,7711
409,ovl_En_St,False,11376,11440,0.994,-64,9358
410,ovl_En_Sth,False,16560,16992,0.975,-432,13479
411,ovl_En_Stream,False,1424,1552,0.918,-128,1209
412,ovl_En_Sw,False,14192,14464,0.981,-272,12048
413,ovl_En_Syateki_Itm,False,3488,4544,0.768,-1056,2938
414,ovl_En_Syateki_Man,False,3520,4224,0.833,-704,3148
415,ovl_En_Syateki_Niw,False,8336,8624,0.967,-288,7291
416,ovl_En_Ta,False,14784,15040,0.983,-256,12815
417,ovl_En_Takara_Man,False,2240,2512,0.892,-272,2019
418,ovl_En_Tana,False,672,1072,0.627,-400,601
419,ovl_En_Tg,False,1744,1824,0.956,-80,1421
420,ovl_En_Tite,False,11680,11904,0.981,-224,10034
421,ovl_En_Tk,False,7728,8080,0.956,-352,6488
422,ovl_En_Torch,False,240,240,1.0,0,37
423,ovl_En_Torch2,False,10080,10160,0.992,-80,8278
424,ovl_En_Toryo,False,3216,3184,1.01,32,2515
425,ovl_En_Tp,False,7760,7952,0.976,-192,6712
426,ovl_En_Tr,False,6400,6512,0.983,-112,5536
427,ovl_En_Trap,False,4768,4752,1.003,16,4003
428,ovl_En_Tubo_Trap,False,3232,3520,0.918,-288,2810
429,ovl_En_Vali,False,9888,10240,0.966,-352,8436
430,ovl_En_Vase,False,256,240,1.067,16,172
431,ovl_En_Vb_Ball,False,4512,4704,0.959,-192,3578
432,ovl_En_Viewer,False,11952,12864,0.929,-912,10664
433,ovl_En_Vm,False,6320,6544,0.966,-224,5317
434,ovl_En_Wall_Tubo,False,1264,1840,0.687,-576,1099
435,ovl_En_Wallmas,False,6672,6912,0.965,-240,5761
436,ovl_En_Weather_Tag,False,3824,4720,0.81,-896,3332
437,ovl_En_Weiyer,False,6656,6688,0.995,-32,5840
438,ovl_En_Wf,False,17168,17328,0.991,-160,13667
439,ovl_En_Wonder_Item,False,3152,4016,0.785,-864,2788
440,ovl_En_Wonder_Talk,False,1680,3552,0.473,-1872,1532
441,ovl_En_Wonder_Talk2,False,1696,4256,0.398,-2560,1546
442,ovl_En_Wood02,False,4560,4704,0.969,-144,3780
443,ovl_En_Xc,False,26464,27568,0.96,-1104,22611
444,ovl_En_Yabusame_Mark,False,1744,3072,0.568,-1328,1571
445,ovl_En_Yukabyun,False,1552,1680,0.924,-128,1334
446,ovl_En_Zf,False,27376,27360,1.001,16,23353
447,ovl_En_Zl1,False,15872,15952,0.995,-80,8751
448,ovl_En_Zl2,False,18224,18976,0.96,-752,15496
449,ovl_En_Zl3,False,32336,33792,0.957,-1456,27713
450,ovl_En_Zl4,False,18992,19056,0.997,-64,13122
451,ovl_En_Zo,False,9648,10144,0.951,-496,7467
452,ovl_En_fHG,False,10544,11616,0.908,-1072,9653
453,ovl_End_Title,False,16688,17024,0.98,-336,12957
454,ovl_Fishing,False,80304,83664,0.96,-3360,71462
455,ovl_Item_B_Heart,False,1008,1184,0.851,-176,861
456,ovl_Item_Etcetera,False,2256,2544,0.887,-288,1968
457,ovl_Item_Inbox,False,352,336,1.048,16,226
458,ovl_Item_Ocarina,False,2000,2032,0.984,-32,1724
459,ovl_Item_Shield,False,2576,2736,0.942,-160,2139
460,ovl_Magic_Dark,False,6224,6560,0.949,-336,5289
461,ovl_Magic_Fire,False,8912,9104,0.979,-192,7843
462,ovl_Magic_Wind,False,7424,8016,0.926,-592,6724
463,ovl_Mir_Ray,False,6336,6704,0.945,-368,5286
464,ovl_Obj_Bean,False,10128,10720,0.945,-592,8888
465,ovl_Obj_Blockstop,False,416,400,1.04,16,291
466,ovl_Obj_Bombiwa,False,1392,1392,1.0,0,948
467,ovl_Obj_Comb,False,2144,2240,0.957,-96,1658
468,ovl_Obj_Dekujr,False,1600,1760,0.909,-160,1201
469,ovl_Obj_Elevator,False,960,1168,0.822,-208,842
470,ovl_Obj_Hamishi,False,2128,2256,0.943,-128,1263
471,ovl_Obj_Hana,False,784,768,1.021,16,586
472,ovl_Obj_Hsblock,False,1488,1792,0.83,-304,1284
473,ovl_Obj_Ice_Poly,False,2480,2624,0.945,-144,849
474,ovl_Obj_Kibako,False,3328,3376,0.986,-48,2605
475,ovl_Obj_Kibako2,False,1728,1792,0.964,-64,921
476,ovl_Obj_Lift,False,2592,2768,0.936,-176,2252
477,ovl_Obj_Lightswitch,False,5168,5840,0.885,-672,3546
478,ovl_Obj_Makekinsuta,False,336,672,0.5,-336,293
479,ovl_Obj_Makeoshihiki,False,1168,1424,0.82,-256,795
480,ovl_Obj_Mure,False,4112,5280,0.779,-1168,3622
481,ovl_Obj_Mure2,False,2592,2704,0.959,-112,2201
482,ovl_Obj_Mure3,False,2000,1968,1.016,32,1087
483,ovl_Obj_Oshihiki,False,6832,7760,0.88,-928,6096
484,ovl_Obj_Roomtimer,False,592,576,1.028,16,423
485,ovl_Obj_Switch,False,7616,8352,0.912,-736,6532
486,ovl_Obj_Syokudai,False,3120,3296,0.947,-176,2709
487,ovl_Obj_Timeblock,False,3136,3520,0.891,-384,2638
488,ovl_Obj_Tsubo,False,4080,4240,0.962,-160,3405
489,ovl_Obj_Warp2block,False,2864,3248,0.882,-384,2282
490,ovl_Object_Kankyo,False,12832,13776,0.931,-944,11398
491,ovl_Oceff_Spot,False,3888,4208,0.924,-320,3418
492,ovl_Oceff_Storm,False,7072,7344,0.963,-272,6468
493,ovl_Oceff_Wipe,False,3408,3616,0.942,-208,2782
494,ovl_Oceff_Wipe2,False,6000,6208,0.966,-208,5471
495,ovl_Oceff_Wipe3,False,5968,6176,0.966,-208,5564
496,ovl_Oceff_Wipe4,False,4064,4272,0.951,-208,3347
497,ovl_Shot_Sun,False,1728,1856,0.931,-128,1469
498,gameplay_keep,True,354224,354224,1.0,0,0
499,gameplay_field_keep,True,54064,54064,1.0,0,0
500,gameplay_dangeon_keep,False,97008,97008,1.0,0,7972
501,gameplay_object_exchange_static,True,16,16,1.0,0,0
502,object_link_boy,False,227328,227328,1.0,0,2023
503,object_link_child,True,184192,184192,1.0,0,0
504,object_box,True,24576,24576,1.0,0,0
505,object_human,True,78208,78208,1.0,0,0
506,object_okuta,True,15488,15488,1.0,0,0
507,object_poh,True,20704,20704,1.0,0,0
508,object_wallmaster,True,41072,41072,1.0,0,0
509,object_dy_obj,True,120112,120112,1.0,0,0
510,object_firefly,True,6336,6336,1.0,0,0
511,object_dodongo,True,39232,39232,1.0,0,0
512,object_fire,True,16544,16544,1.0,0,0
513,object_niw,True,9536,9536,1.0,0,0
514,object_tite,True,14896,14896,1.0,0,0
515,object_reeba,True,7920,7920,1.0,0,0
516,object_peehat,True,7312,7312,1.0,0,0
517,object_kingdodongo,True,199904,199904,1.0,0,0
518,object_horse,True,57104,57104,1.0,0,0
519,object_zf,True,91040,91040,1.0,0,0
520,object_goma,True,128512,128512,1.0,0,0
521,object_zl1,True,82880,82880,1.0,0,0
522,object_gol,True,16928,16928,1.0,0,0
523,object_bubble,True,4288,4288,1.0,0,0
524,object_dodojr,True,8432,8432,1.0,0,0
525,object_torch2,True,18288,18288,1.0,0,0
526,object_bl,True,22608,22608,1.0,0,0
527,object_tp,True,7408,7408,1.0,0,0
528,object_oA1,True,18192,18192,1.0,0,0
529,object_st,True,23472,23472,1.0,0,0
530,object_bw,True,8800,8800,1.0,0,0
531,object_ei,True,13344,13344,1.0,0,0
532,object_horse_normal,True,40896,40896,1.0,0,0
533,object_oB1,True,26288,26288,1.0,0,0
534,object_o_anime,True,8528,8528,1.0,0,0
535,object_spot04_objects,True,5824,5824,1.0,0,0
536,object_ddan_objects,True,34656,34656,1.0,0,0
537,object_hidan_objects,True,97568,97568,1.0,0,0
538,object_horse_ganon,True,49296,49296,1.0,0,0
539,object_oA2,True,22224,22224,1.0,0,0
540,object_spot00_objects,True,7184,7184,1.0,0,0
541,object_mb,True,82336,82336,1.0,0,0
542,object_bombf,True,6656,6656,1.0,0,0
543,object_sk2,True,59392,59392,1.0,0,0
544,object_oE1,True,26640,26640,1.0,0,0
545,object_oE_anime,True,20576,20576,1.0,0,0
546,object_oE2,True,23152,23152,1.0,0,0
547,object_ydan_objects,True,36992,36992,1.0,0,0
548,object_gnd,True,77824,77824,1.0,0,0
549,object_am,True,23376,23376,1.0,0,0
550,object_dekubaba,True,14784,14784,1.0,0,0
551,object_oA3,True,8496,8496,1.0,0,0
552,object_oA4,True,5936,5936,1.0,0,0
553,object_oA5,True,5808,5808,1.0,0,0
554,object_oA6,True,6656,6656,1.0,0,0
555,object_oA7,True,5456,5456,1.0,0,0
556,object_jj,True,47808,47808,1.0,0,0
557,object_oA8,True,6064,6064,1.0,0,0
558,object_oA9,True,1312,1312,1.0,0,0
559,object_oB2,True,16608,16608,1.0,0,0
560,object_oB3,True,17552,17552,1.0,0,0
561,object_oB4,True,6256,6256,1.0,0,0
562,object_horse_zelda,True,29024,29024,1.0,0,0
563,object_opening_demo1,True,20576,20576,1.0,0,0
564,object_warp1,True,11440,11440,1.0,0,0
565,object_b_heart,True,1600,1600,1.0,0,0
566,object_dekunuts,True,13920,13920,1.0,0,0
567,object_oE3,True,28960,28960,1.0,0,0
568,object_oE4,True,20432,20432,1.0,0,0
569,object_menkuri_objects,False,35600,35600,1.0,0,188
570,object_oE5,True,21952,21952,1.0,0,0
571,object_oE6,True,11856,11856,1.0,0,0
572,object_oE7,True,10848,10848,1.0,0,0
573,object_oE8,True,13264,13264,1.0,0,0
574,object_oE9,True,12048,12048,1.0,0,0
575,object_oE10,True,10704,10704,1.0,0,0
576,object_oE11,True,12784,12784,1.0,0,0
577,object_oE12,True,14272,14272,1.0,0,0
578,object_vali,True,18512,18512,1.0,0,0
579,object_oA10,True,11952,11952,1.0,0,0
580,object_oA11,True,5568,5568,1.0,0,0
581,object_mizu_objects,True,45856,45856,1.0,0,0
582,object_fhg,True,74208,74208,1.0,0,0
583,object_ossan,True,39760,39760,1.0,0,0
584,object_mori_hineri1,True,21744,21744,1.0,0,0
585,object_Bb,True,6720,6720,1.0,0,0
586,object_toki_objects,True,33872,33872,1.0,0,0
587,object_yukabyun,True,5360,5360,1.0,0,0
588,object_zl2,True,68992,68992,1.0,0,0
589,object_mjin,True,4752,4752,1.0,0,0
590,object_mjin_flash,True,4096,4096,1.0,0,0
591,object_mjin_dark,True,4096,4096,1.0,0,0
592,object_mjin_flame,True,4096,4096,1.0,0,0
593,object_mjin_ice,True,4096,4096,1.0,0,0
594,object_mjin_soul,True,4096,4096,1.0,0,0
595,object_mjin_wind,True,4096,4096,1.0,0,0
596,object_mjin_oka,True,7008,7008,1.0,0,0
597,object_haka_objects,False,120496,120496,1.0,0,509
598,object_spot06_objects,True,11680,11680,1.0,0,0
599,object_ice_objects,True,36176,36176,1.0,0,0
600,object_relay_objects,True,13872,13872,1.0,0,0
601,object_mori_hineri1a,True,13504,13504,1.0,0,0
602,object_mori_hineri2,True,17408,17408,1.0,0,0
603,object_mori_hineri2a,True,24752,24752,1.0,0,0
604,object_mori_objects,True,35344,35344,1.0,0,0
605,object_mori_tex,True,40448,40448,1.0,0,0
606,object_spot08_obj,True,22016,22016,1.0,0,0
607,object_warp2,True,16,16,1.0,0,0
608,object_hata,True,12256,12256,1.0,0,0
609,object_bird,True,8608,8608,1.0,0,0
610,object_wood02,True,34768,34768,1.0,0,0
611,object_lightbox,True,8000,8000,1.0,0,0
612,object_pu_box,True,5632,5632,1.0,0,0
613,object_trap,True,9184,9184,1.0,0,0
614,object_vase,True,5520,5520,1.0,0,0
615,object_im,True,74288,74288,1.0,0,0
616,object_ta,True,58352,58352,1.0,0,0
617,object_tk,True,48720,48720,1.0,0,0
618,object_xc,True,114944,114944,1.0,0,0
619,object_vm,True,16240,16240,1.0,0,0
620,object_bv,True,127408,127408,1.0,0,0
621,object_hakach_objects,True,27376,27376,1.0,0,0
622,object_efc_crystal_light,True,2720,2720,1.0,0,0
623,object_efc_fire_ball,True,3328,3328,1.0,0,0
624,object_efc_flash,True,16,16,1.0,0,0
625,object_efc_lgt_shower,True,4816,4816,1.0,0,0
626,object_efc_star_field,True,6096,6096,1.0,0,0
627,object_god_lgt,True,17232,17232,1.0,0,0
628,object_light_ring,True,4736,4736,1.0,0,0
629,object_triforce_spot,True,10512,10512,1.0,0,0
630,object_medal,True,20800,20800,1.0,0,0
631,object_bdan_objects,True,52496,52496,1.0,0,0
632,object_sd,True,50912,50912,1.0,0,0
633,object_rd,True,61424,61424,1.0,0,0
634,object_po_sisters,True,58304,58304,1.0,0,0
635,object_heavy_object,False,6880,6880,1.0,0,755
636,object_gndd,True,72192,72192,1.0,0,0
637,object_fd,True,71280,71280,1.0,0,0
638,object_du,True,73776,73776,1.0,0,0
639,object_fw,True,32224,32224,1.0,0,0
640,object_horse_link_child,True,35616,35616,1.0,0,0
641,object_spot02_objects,True,91680,91680,1.0,0,0
642,object_haka,True,5216,5216,1.0,0,0
643,object_ru1,True,80512,80512,1.0,0,0
644,object_syokudai,True,15504,15504,1.0,0,0
645,object_fd2,True,72336,72336,1.0,0,0
646,object_dh,True,37056,37056,1.0,0,0
647,object_rl,True,31568,31568,1.0,0,0
648,object_efc_tw,True,4848,4848,1.0,0,0
649,object_demo_tre_lgt,True,16,16,1.0,0,0
650,object_gi_key,True,2592,2592,1.0,0,0
651,object_mir_ray,False,7424,7424,1.0,0,612
652,object_brob,True,6816,6816,1.0,0,0
653,object_gi_jewel,True,13952,13952,1.0,0,0
654,object_spot09_obj,True,100496,100496,1.0,0,0
655,object_spot18_obj,True,51728,51728,1.0,0,0
656,object_bdoor,True,30144,30144,1.0,0,0
657,object_spot17_obj,True,6192,6192,1.0,0,0
658,object_shop_dungen,True,14880,14880,1.0,0,0
659,object_nb,True,98784,98784,1.0,0,0
660,object_mo,True,36976,36976,1.0,0,0
661,object_sb,True,11424,11424,1.0,0,0
662,object_gi_melody,True,3360,3360,1.0,0,0
663,object_gi_heart,True,496,496,1.0,0,0
664,object_gi_compass,True,3344,3344,1.0,0,0
665,object_gi_bosskey,True,4112,4112,1.0,0,0
666,object_gi_medal,True,21360,21360,1.0,0,0
667,object_gi_nuts,True,4544,4544,1.0,0,0
668,object_sa,True,86576,86576,1.0,0,0
669,object_gi_hearts,True,6064,6064,1.0,0,0
670,object_gi_arrowcase,True,3248,3248,1.0,0,0
671,object_gi_bombpouch,True,3680,3680,1.0,0,0
672,object_in,True,101456,101456,1.0,0,0
673,object_tr,True,77360,77360,1.0,0,0
674,object_spot16_obj,True,5376,5376,1.0,0,0
675,object_oE1s,True,25952,25952,1.0,0,0
676,object_oE4s,True,19968,19968,1.0,0,0
677,object_os_anime,True,42560,42560,1.0,0,0
678,object_gi_bottle,True,2288,2288,1.0,0,0
679,object_gi_stick,True,1728,1728,1.0,0,0
680,object_gi_map,True,4448,4448,1.0,0,0
681,object_oF1d_map,True,66976,66976,1.0,0,0
682,object_ru2,True,63696,63696,1.0,0,0
683,object_gi_shield_1,True,3408,3408,1.0,0,0
684,object_dekujr,True,13584,13584,1.0,0,0
685,object_gi_magicpot,True,4560,4560,1.0,0,0
686,object_gi_bomb_1,True,3248,3248,1.0,0,0
687,object_oF1s,True,34976,34976,1.0,0,0
688,object_ma2,True,40688,40688,1.0,0,0
689,object_gi_purse,True,7024,7024,1.0,0,0
690,object_hni,True,44912,44912,1.0,0,0
691,object_tw,True,241584,241584,1.0,0,0
692,object_rr,True,3584,3584,1.0,0,0
693,object_bxa,True,11248,11248,1.0,0,0
694,object_anubice,True,14752,14752,1.0,0,0
695,object_gi_gerudo,False,4928,4928,1.0,0,1007
696,object_gi_arrow,True,6928,6928,1.0,0,0
697,object_gi_bomb_2,True,1696,1696,1.0,0,0
698,object_gi_egg,True,4896,4896,1.0,0,0
699,object_gi_scale,True,3568,3568,1.0,0,0
700,object_gi_shield_2,True,4208,4208,1.0,0,0
701,object_gi_hookshot,True,5472,5472,1.0,0,0
702,object_gi_ocarina,True,2992,2992,1.0,0,0
703,object_gi_milk,True,5232,5232,1.0,0,0
704,object_ma1,True,36224,36224,1.0,0,0
705,object_ganon,True,70912,70912,1.0,0,0
706,object_sst,True,109488,109488,1.0,0,0
707,object_ny,True,8560,8560,1.0,0,0
708,object_fr,True,46256,46256,1.0,0,0
709,object_gi_pachinko,True,3168,3168,1.0,0,0
710,object_gi_boomerang,True,3488,3488,1.0,0,0
711,object_gi_bow,True,3376,3376,1.0,0,0
712,object_gi_glasses,True,4480,4480,1.0,0,0
713,object_gi_liquid,True,6352,6352,1.0,0,0
714,object_ani,True,30464,30464,1.0,0,0
715,object_demo_6k,True,15264,15264,1.0,0,0
716,object_gi_shield_3,False,4800,4800,1.0,0,572
717,object_gi_letter,True,3584,3584,1.0,0,0
718,object_spot15_obj,True,7424,7424,1.0,0,0
719,object_jya_obj,False,115008,115008,1.0,0,1138
720,object_gi_clothes,True,6240,6240,1.0,0,0
721,object_gi_bean,True,2240,2240,1.0,0,0
722,object_gi_fish,True,2384,2384,1.0,0,0
723,object_gi_saw,True,2944,2944,1.0,0,0
724,object_gi_hammer,True,3264,3264,1.0,0,0
725,object_gi_grass,True,3088,3088,1.0,0,0
726,object_gi_longsword,True,2240,2240,1.0,0,0
727,object_spot01_objects,True,9360,9360,1.0,0,0
728,object_md,True,41296,41296,1.0,0,0
729,object_km1,True,22976,22976,1.0,0,0
730,object_kw1,True,26848,26848,1.0,0,0
731,object_zo,True,49216,49216,1.0,0,0
732,object_kz,True,34528,34528,1.0,0,0
733,object_umajump,True,5232,5232,1.0,0,0
734,object_masterkokiri,True,1216,1216,1.0,0,0
735,object_masterkokirihead,True,11424,11424,1.0,0,0
736,object_mastergolon,True,272,272,1.0,0,0
737,object_masterzoora,True,1952,1952,1.0,0,0
738,object_aob,True,22192,22192,1.0,0,0
739,object_ik,True,132560,132560,1.0,0,0
740,object_ahg,True,22960,22960,1.0,0,0
741,object_cne,True,10704,10704,1.0,0,0
742,object_gi_niwatori,True,6640,6640,1.0,0,0
743,object_skj,True,36400,36400,1.0,0,0
744,object_gi_bottle_letter,True,3200,3200,1.0,0,0
745,object_bji,True,16784,16784,1.0,0,0
746,object_bba,True,17040,17040,1.0,0,0
747,object_gi_ocarina_0,True,3088,3088,1.0,0,0
748,object_ds,True,18304,18304,1.0,0,0
749,object_ane,True,28592,28592,1.0,0,0
750,object_boj,True,23744,23744,1.0,0,0
751,object_spot03_object,True,5728,5728,1.0,0,0
752,object_spot07_object,True,27952,27952,1.0,0,0
753,object_fz,True,13520,13520,1.0,0,0
754,object_bob,True,20256,20256,1.0,0,0
755,object_ge1,True,42160,42160,1.0,0,0
756,object_yabusame_point,True,3664,3664,1.0,0,0
757,object_gi_boots_2,True,7104,7104,1.0,0,0
758,object_gi_seed,True,2752,2752,1.0,0,0
759,object_gnd_magic,True,4736,4736,1.0,0,0
760,object_d_elevator,True,5008,5008,1.0,0,0
761,object_d_hsblock,True,5984,5984,1.0,0,0
762,object_d_lift,True,6144,6144,1.0,0,0
763,object_mamenoki,True,9952,9952,1.0,0,0
764,object_goroiwa,True,6304,6304,1.0,0,0
765,object_toryo,True,29024,29024,1.0,0,0
766,object_daiku,True,34928,34928,1.0,0,0
767,object_nwc,True,3488,3488,1.0,0,0
768,object_blkobj,True,80016,80016,1.0,0,0
769,object_gm,True,720,720,1.0,0,0
770,object_ms,True,15824,15824,1.0,0,0
771,object_hs,True,25200,25200,1.0,0,0
772,object_ingate,True,4592,4592,1.0,0,0
773,object_lightswitch,True,9248,9248,1.0,0,0
774,object_kusa,True,896,896,1.0,0,0
775,object_tsubo,True,6640,6640,1.0,0,0
776,object_gi_gloves,True,6496,6496,1.0,0,0
777,object_gi_coin,True,2128,2128,1.0,0,0
778,object_kanban,True,6064,6064,1.0,0,0
779,object_gjyo_objects,True,5616,5616,1.0,0,0
780,object_owl,True,65728,65728,1.0,0,0
781,object_mk,True,24064,24064,1.0,0,0
782,object_fu,True,27808,27808,1.0,0,0
783,object_gi_ki_tan_mask,True,3568,3568,1.0,0,0
784,object_gi_redead_mask,True,2704,2704,1.0,0,0
785,object_gi_skj_mask,True,3296,3296,1.0,0,0
786,object_gi_rabit_mask,True,3840,3840,1.0,0,0
787,object_gi_truth_mask,True,6240,6240,1.0,0,0
788,object_ganon_objects,True,4464,4464,1.0,0,0
789,object_siofuki,True,3504,3504,1.0,0,0
790,object_stream,True,2688,2688,1.0,0,0
791,object_mm,True,32880,32880,1.0,0,0
792,object_fa,True,15248,15248,1.0,0,0
793,object_os,True,18032,18032,1.0,0,0
794,object_gi_eye_lotion,True,2416,2416,1.0,0,0
795,object_gi_powder,True,2944,2944,1.0,0,0
796,object_gi_mushroom,True,3280,3280,1.0,0,0
797,object_gi_ticketstone,True,4768,4768,1.0,0,0
798,object_gi_brokensword,True,2448,2448,1.0,0,0
799,object_js,True,24368,24368,1.0,0,0
800,object_cs,True,34128,34128,1.0,0,0
801,object_gi_prescription,True,3104,3104,1.0,0,0
802,object_gi_bracelet,True,3056,3056,1.0,0,0
803,object_gi_soldout,True,1232,1232,1.0,0,0
804,object_gi_frog,True,4368,4368,1.0,0,0
805,object_mag,False,128064,153920,0.832,-25856,63707
806,object_door_gerudo,True,2464,2464,1.0,0,0
807,object_gt,True,79344,79344,1.0,0,0
808,object_efc_erupc,True,10480,10480,1.0,0,0
809,object_zl2_anime1,True,46608,46608,1.0,0,0
810,object_zl2_anime2,True,43744,43744,1.0,0,0
811,object_gi_golonmask,True,6064,6064,1.0,0,0
812,object_gi_zoramask,True,5680,5680,1.0,0,0
813,object_gi_gerudomask,True,5120,5120,1.0,0,0
814,object_ganon2,True,220144,220144,1.0,0,0
815,object_ka,True,26560,26560,1.0,0,0
816,object_ts,True,20464,20464,1.0,0,0
817,object_zg,True,4608,4608,1.0,0,0
818,object_gi_hoverboots,True,7792,7792,1.0,0,0
819,object_gi_m_arrow,True,3712,3712,1.0,0,0
820,object_ds2,True,17008,17008,1.0,0,0
821,object_ec,True,51504,51504,1.0,0,0
822,object_fish,True,87536,87536,1.0,0,0
823,object_gi_sutaru,True,1616,1616,1.0,0,0
824,object_gi_goddess,True,3152,3152,1.0,0,0
825,object_ssh,True,23552,23552,1.0,0,0
826,object_bigokuta,True,27600,27600,1.0,0,0
827,object_bg,True,29376,29376,1.0,0,0
828,object_spot05_objects,True,4848,4848,1.0,0,0
829,object_spot12_obj,True,9152,9152,1.0,0,0
830,object_bombiwa,True,2816,2816,1.0,0,0
831,object_hintnuts,True,12608,12608,1.0,0,0
832,object_rs,True,18560,18560,1.0,0,0
833,object_spot00_break,True,7712,7712,1.0,0,0
834,object_gla,True,40688,40688,1.0,0,0
835,object_shopnuts,True,17808,17808,1.0,0,0
836,object_geldb,True,46832,46832,1.0,0,0
837,object_gr,True,40080,40080,1.0,0,0
838,object_dog,True,29344,29344,1.0,0,0
839,object_jya_iron,True,9824,9824,1.0,0,0
840,object_jya_door,True,8832,8832,1.0,0,0
841,object_spot01_objects2,True,16,16,1.0,0,0
842,object_spot11_obj,True,6800,6800,1.0,0,0
843,object_kibako2,True,4288,4288,1.0,0,0
844,object_dns,True,14288,14288,1.0,0,0
845,object_dnk,True,11824,11824,1.0,0,0
846,object_gi_fire,True,4064,4064,1.0,0,0
847,object_gi_insect,True,3056,3056,1.0,0,0
848,object_gi_butterfly,True,3024,3024,1.0,0,0
849,object_gi_ghost,True,3504,3504,1.0,0,0
850,object_gi_soul,True,4016,4016,1.0,0,0
851,object_bowl,True,13552,13552,1.0,0,0
852,object_po_field,True,27200,27200,1.0,0,0
853,object_demo_kekkai,True,60688,60688,1.0,0,0
854,object_efc_doughnut,True,4176,4176,1.0,0,0
855,object_gi_dekupouch,True,4176,4176,1.0,0,0
856,object_ganon_anime1,True,48192,48192,1.0,0,0
857,object_ganon_anime2,True,66864,66864,1.0,0,0
858,object_ganon_anime3,True,83952,83952,1.0,0,0
859,object_gi_rupy,True,2048,2048,1.0,0,0
860,object_spot01_matoya,True,15504,15504,1.0,0,0
861,object_spot01_matoyab,True,8672,8672,1.0,0,0
862,object_po_composer,True,28576,28576,1.0,0,0
863,object_mu,True,44624,44624,1.0,0,0
864,object_wf,True,42240,42240,1.0,0,0
865,object_skb,True,18448,18448,1.0,0,0
866,object_gj,True,42784,42784,1.0,0,0
867,object_geff,True,4016,4016,1.0,0,0
868,object_haka_door,True,14704,14704,1.0,0,0
869,object_gs,True,2688,2688,1.0,0,0
870,object_ps,True,51456,51456,1.0,0,0
871,object_bwall,True,4432,4432,1.0,0,0
872,object_crow,True,4304,4304,1.0,0,0
873,object_cow,True,20144,20144,1.0,0,0
874,object_cob,True,8720,8720,1.0,0,0
875,object_gi_sword_1,True,3360,3360,1.0,0,0
876,object_door_killer,True,7136,7136,1.0,0,0
877,object_ouke_haka,True,2416,2416,1.0,0,0
878,object_timeblock,True,2912,2912,1.0,0,0
879,object_zl4,True,118304,118304,1.0,0,0
880,g_pn_01,True,10368,10368,1.0,0,0
881,g_pn_02,True,10368,10368,1.0,0,0
882,g_pn_03,True,10368,10368,1.0,0,0
883,g_pn_04,True,10368,10368,1.0,0,0
884,g_pn_05,True,10368,10368,1.0,0,0
885,g_pn_06,True,10368,10368,1.0,0,0
886,g_pn_07,True,10368,10368,1.0,0,0
887,g_pn_08,True,10368,10368,1.0,0,0
888,g_pn_09,True,10368,10368,1.0,0,0
889,g_pn_10,True,10368,10368,1.0,0,0
890,g_pn_11,True,10368,10368,1.0,0,0
891,g_pn_12,True,10368,10368,1.0,0,0
892,g_pn_13,True,10368,10368,1.0,0,0
893,g_pn_14,True,10368,10368,1.0,0,0
894,g_pn_15,True,10368,10368,1.0,0,0
895,g_pn_16,True,10368,10368,1.0,0,0
896,g_pn_17,True,10368,10368,1.0,0,0
897,g_pn_18,True,10368,10368,1.0,0,0
898,g_pn_19,True,10368,10368,1.0,0,0
899,g_pn_20,True,10368,10368,1.0,0,0
900,g_pn_21,True,10368,10368,1.0,0,0
901,g_pn_22,True,10368,10368,1.0,0,0
902,g_pn_23,True,10368,10368,1.0,0,0
903,g_pn_24,True,10368,10368,1.0,0,0
904,g_pn_25,True,10368,10368,1.0,0,0
905,g_pn_26,True,10368,10368,1.0,0,0
906,g_pn_27,True,10368,10368,1.0,0,0
907,g_pn_28,True,10368,10368,1.0,0,0
908,g_pn_29,True,10368,10368,1.0,0,0
909,g_pn_30,True,10368,10368,1.0,0,0
910,g_pn_31,True,10368,10368,1.0,0,0
911,g_pn_32,True,10368,10368,1.0,0,0
912,g_pn_33,True,10368,10368,1.0,0,0
913,g_pn_34,True,10368,10368,1.0,0,0
914,g_pn_35,True,10368,10368,1.0,0,0
915,g_pn_36,True,10368,10368,1.0,0,0
916,g_pn_37,True,10368,10368,1.0,0,0
917,g_pn_38,True,10368,10368,1.0,0,0
918,g_pn_39,True,10368,10368,1.0,0,0
919,g_pn_40,True,10368,10368,1.0,0,0
920,g_pn_41,True,10368,10368,1.0,0,0
921,g_pn_42,True,10368,10368,1.0,0,0
922,g_pn_43,True,10368,10368,1.0,0,0
923,g_pn_44,True,10368,10368,1.0,0,0
924,g_pn_45,True,10368,10368,1.0,0,0
925,g_pn_46,True,10368,10368,1.0,0,0
926,g_pn_47,True,10368,10368,1.0,0,0
927,g_pn_48,True,10368,10368,1.0,0,0
928,g_pn_49,True,10368,10368,1.0,0,0
929,g_pn_50,True,10368,10368,1.0,0,0
930,g_pn_51,True,10368,10368,1.0,0,0
931,g_pn_52,True,10368,10368,1.0,0,0
932,g_pn_53,True,10368,10368,1.0,0,0
933,g_pn_54,True,10368,10368,1.0,0,0
934,g_pn_55,True,10368,10368,1.0,0,0
935,g_pn_56,True,10368,10368,1.0,0,0
936,g_pn_57,True,10368,10368,1.0,0,0
937,z_select_static,True,8704,8704,1.0,0,0
938,nintendo_rogo_static,True,11712,11712,1.0,0,0
939,title_static,False,316096,291904,1.083,24192,250437
940,parameter_static,True,15104,15104,1.0,0,0
941,vr_fine0_static,True,49152,49152,1.0,0,0
942,vr_fine0_pal_static,True,256,256,1.0,0,0
943,vr_fine1_static,True,49152,49152,1.0,0,0
944,vr_fine1_pal_static,True,256,256,1.0,0,0
945,vr_fine2_static,True,49152,49152,1.0,0,0
946,vr_fine2_pal_static,True,256,256,1.0,0,0
947,vr_fine3_static,True,49152,49152,1.0,0,0
948,vr_fine3_pal_static,True,256,256,1.0,0,0
949,vr_cloud0_static,True,49152,49152,1.0,0,0
950,vr_cloud0_pal_static,True,256,256,1.0,0,0
951,vr_cloud1_static,True,49152,49152,1.0,0,0
952,vr_cloud1_pal_static,True,256,256,1.0,0,0
953,vr_cloud2_static,True,49152,49152,1.0,0,0
954,vr_cloud2_pal_static,True,256,256,1.0,0,0
955,vr_cloud3_static,True,49152,49152,1.0,0,0
956,vr_cloud3_pal_static,True,256,256,1.0,0,0
957,vr_holy0_static,True,65536,65536,1.0,0,0
958,vr_holy0_pal_static,True,256,256,1.0,0,0
959,vr_holy1_static,True,65536,65536,1.0,0,0
960,vr_holy1_pal_static,True,256,256,1.0,0,0
961,vr_MDVR_static,True,262144,262144,1.0,0,0
962,vr_MDVR_pal_static,True,2048,2048,1.0,0,0
963,vr_MNVR_static,True,262144,262144,1.0,0,0
964,vr_MNVR_pal_static,True,2048,2048,1.0,0,0
965,vr_RUVR_static,True,262144,262144,1.0,0,0
966,vr_RUVR_pal_static,True,2048,2048,1.0,0,0
967,vr_LHVR_static,True,262144,262144,1.0,0,0
968,vr_LHVR_pal_static,True,2048,2048,1.0,0,0
969,vr_KHVR_static,True,262144,262144,1.0,0,0
970,vr_KHVR_pal_static,True,2048,2048,1.0,0,0
971,vr_K3VR_static,True,196608,196608,1.0,0,0
972,vr_K3VR_pal_static,True,1536,1536,1.0,0,0
973,vr_K4VR_static,True,196608,196608,1.0,0,0
974,vr_K4VR_pal_static,True,1536,1536,1.0,0,0
975,vr_K5VR_static,True,196608,196608,1.0,0,0
976,vr_K5VR_pal_static,True,1536,1536,1.0,0,0
977,vr_SP1a_static,True,131072,131072,1.0,0,0
978,vr_SP1a_pal_static,True,1024,1024,1.0,0,0
979,vr_MLVR_static,True,262144,262144,1.0,0,0
980,vr_MLVR_pal_static,True,2048,2048,1.0,0,0
981,vr_KKRVR_static,True,262144,262144,1.0,0,0
982,vr_KKRVR_pal_static,True,2048,2048,1.0,0,0
983,vr_KR3VR_static,True,196608,196608,1.0,0,0
984,vr_KR3VR_pal_static,True,1536,1536,1.0,0,0
985,vr_IPVR_static,True,262144,262144,1.0,0,0
986,vr_IPVR_pal_static,True,2048,2048,1.0,0,0
987,vr_KSVR_static,True,131072,131072,1.0,0,0
988,vr_KSVR_pal_static,True,1024,1024,1.0,0,0
989,vr_GLVR_static,True,131072,131072,1.0,0,0
990,vr_GLVR_pal_static,True,1024,1024,1.0,0,0
991,vr_ZRVR_static,True,131072,131072,1.0,0,0
992,vr_ZRVR_pal_static,True,1024,1024,1.0,0,0
993,vr_DGVR_static,True,131072,131072,1.0,0,0
994,vr_DGVR_pal_static,True,1024,1024,1.0,0,0
995,vr_ALVR_static,True,131072,131072,1.0,0,0
996,vr_ALVR_pal_static,True,1024,1024,1.0,0,0
997,vr_NSVR_static,True,131072,131072,1.0,0,0
998,vr_NSVR_pal_static,True,1024,1024,1.0,0,0
999,vr_LBVR_static,True,262144,262144,1.0,0,0
1000,vr_LBVR_pal_static,True,2048,2048,1.0,0,0
1001,vr_TTVR_static,True,196608,196608,1.0,0,0
1002,vr_TTVR_pal_static,True,1536,1536,1.0,0,0
1003,vr_FCVR_static,True,131072,131072,1.0,0,0
1004,vr_FCVR_pal_static,True,1024,1024,1.0,0,0
1005,elf_message_field,True,112,112,1.0,0,0
1006,elf_message_ydan,True,16,16,1.0,0,0
1007,syotes_scene,,7168,,,,
1008,syotes_room_0,,53120,,,,
1009,syotes2_scene,,9392,,,,
1010,syotes2_room_0,,40704,,,,
1011,depth_test_scene,,768,,,,
1012,depth_test_room_0,,155376,,,,
1013,spot00_scene,False,11552,172576,0.067,-161024,11074
1014,spot00_room_0,False,7712,86576,0.089,-78864,6932
1015,spot01_scene,False,46256,115024,0.402,-68768,42554
1016,spot01_room_0,False,10656,40672,0.262,-30016,9986
1017,spot02_scene,False,6400,48256,0.133,-41856,5917
1018,spot02_room_0,False,24256,9952,2.437,14304,8311
1019,spot02_room_1,False,55984,122768,0.456,-66784,51114
1020,spot03_scene,False,49856,46432,1.074,3424,44188
1021,spot03_room_0,False,30448,55680,0.547,-25232,25336
1022,spot03_room_1,False,70960,29952,2.369,41008,27414
1023,spot04_scene,False,65424,70208,0.932,-4784,61880
1024,spot04_room_0,False,37520,111760,0.336,-74240,34586
1025,spot04_room_1,False,20352,34176,0.596,-13824,18056
1026,spot04_room_2,False,31776,20592,1.543,11184,18992
1027,spot05_scene,False,41296,85344,0.484,-44048,38833
1028,spot05_room_0,False,20704,40704,0.509,-20000,18815
1029,spot06_scene,False,32576,111664,0.292,-79088,30855
1030,spot06_room_0,False,33584,42528,0.79,-8944,31475
1031,spot07_scene,False,33296,38944,0.855,-5648,31086
1032,spot07_room_0,False,14576,25328,0.575,-10752,13322
1033,spot07_room_1,False,23648,51616,0.458,-27968,22399
1034,spot08_scene,False,752,71328,0.011,-70576,572
1035,spot08_room_0,False,169904,33120,5.13,136784,28510
1036,spot09_scene,False,70544,69984,1.008,560,67015
1037,spot09_room_0,False,43232,34752,1.244,8480,29293
1038,spot10_scene,False,19312,66608,0.29,-47296,16987
1039,spot10_room_0,False,80624,9712,8.301,70912,8181
1040,spot10_room_1,False,4688,33840,0.139,-29152,3725
1041,spot10_room_2,False,481024,19440,24.744,461584,19182
1042,spot10_room_3,False,73248,23216,3.155,50032,20895
1043,spot10_room_4,False,26320,9424,2.793,16896,7520
1044,spot10_room_5,False,5680,28656,0.198,-22976,4801
1045,spot10_room_6,False,10272,15088,0.681,-4816,8086
1046,spot10_room_7,False,1072,9664,0.111,-8592,765
1047,spot10_room_8,False,154480,9840,15.699,144640,9431
1048,spot10_room_9,False,992,15328,0.065,-14336,711
1049,spot11_scene,False,154464,103648,1.49,50816,99190
1050,spot11_room_0,False,4848,51136,0.095,-46288,3900
1051,spot12_scene,False,481008,65152,7.383,415856,61734
1052,spot12_room_0,False,15712,71104,0.221,-55392,13459
1053,spot12_room_1,False,1600,49312,0.032,-47712,1191
1054,spot13_scene,False,6048,24112,0.251,-18064,4912
1055,spot13_room_0,False,222736,2320,96.007,220416,1492
1056,spot13_room_1,False,105280,76352,1.379,28928,73669
1057,spot15_scene,False,69440,99584,0.697,-30144,66025
1058,spot15_room_0,False,37632,53696,0.701,-16064,34029
1059,spot16_scene,False,23568,125584,0.188,-102016,22260
1060,spot16_room_0,False,15184,44304,0.343,-29120,13554
1061,spot17_scene,False,29296,65248,0.449,-35952,27695
1062,spot17_room_0,False,98112,26752,3.667,71360,23750
1063,spot17_room_1,False,18432,74592,0.247,-56160,16167
1064,spot18_scene,False,21776,42064,0.518,-20288,20290
1065,spot18_room_0,False,32880,75728,0.434,-42848,30512
1066,spot18_room_1,False,24048,25088,0.959,-1040,22641
1067,spot18_room_2,False,33184,72112,0.46,-38928,30993
1068,spot18_room_3,False,4112,122096,0.034,-117984,3707
1069,ydan_scene,False,86336,55840,1.546,30496,50299
1070,ydan_room_0,False,112800,86864,1.299,25936,81367
1071,ydan_room_1,False,39680,16896,2.348,22784,15634
1072,ydan_room_2,False,32160,24368,1.32,7792,22260
1073,ydan_room_3,False,56768,82352,0.689,-25584,51405
1074,ydan_room_4,False,38992,19504,1.999,19488,17861
1075,ydan_room_5,False,24288,33680,0.721,-9392,21046
1076,ydan_room_6,False,9216,20224,0.456,-11008,8636
1077,ydan_room_7,False,30416,35488,0.857,-5072,27631
1078,ydan_room_8,False,37888,3472,10.912,34416,2925
1079,ydan_room_9,False,46416,39072,1.188,7344,36565
1080,ydan_room_10,False,32336,19968,1.619,12368,18299
1081,ydan_room_11,False,8320,29040,0.287,-20720,7746
1082,ddan_scene,False,34608,86336,0.401,-51728,32984
1083,ddan_room_0,False,9344,112800,0.083,-103456,8641
1084,ddan_room_1,False,9360,39792,0.235,-30432,8526
1085,ddan_room_2,False,10320,32448,0.318,-22128,9618
1086,ddan_room_3,False,21840,56944,0.384,-35104,20127
1087,ddan_room_4,False,172608,39264,4.396,133344,37296
1088,ddan_room_5,False,86576,24256,3.569,62320,22261
1089,ddan_room_6,False,115056,9392,12.25,105664,8822
1090,ddan_room_7,False,40672,30464,1.335,10208,27527
1091,ddan_room_8,False,48256,38304,1.26,9952,35948
1092,ddan_room_9,False,9952,46384,0.215,-36432,7869
1093,ddan_room_10,False,122768,32528,3.774,90240,30152
1094,ddan_room_11,False,46432,8240,5.635,38192,7575
1095,ddan_room_12,False,55680,34688,1.605,20992,31731
1096,ddan_room_13,False,29952,9424,3.178,20528,8762
1097,ddan_room_14,False,70256,9424,7.455,60832,9023
1098,ddan_room_15,False,111760,10544,10.599,101216,9781
1099,ddan_room_16,False,34176,21856,1.564,12320,20907
1100,bdan_scene,False,20592,88032,0.234,-67440,19122
1101,bdan_room_0,False,85360,16704,5.11,68656,14770
1102,bdan_room_1,False,40704,24512,1.661,16192,21085
1103,bdan_room_2,False,111680,37440,2.983,74240,34647
1104,bdan_room_3,False,42528,29280,1.452,13248,26339
1105,bdan_room_4,False,38960,16640,2.341,22320,15375
1106,bdan_room_5,False,25328,24720,1.025,608,22840
1107,bdan_room_6,False,51616,16960,3.043,34656,14865
1108,bdan_room_7,False,71328,13520,5.276,57808,12643
1109,bdan_room_8,False,33120,14400,2.3,18720,11236
1110,bdan_room_9,False,70032,15408,4.545,54624,13090
1111,bdan_room_10,False,34752,14368,2.419,20384,11462
1112,bdan_room_11,False,66608,14832,4.491,51776,12361
1113,bdan_room_12,False,9712,15584,0.623,-5872,7521
1114,bdan_room_13,False,33840,11136,3.039,22704,10155
1115,bdan_room_14,False,19440,25040,0.776,-5600,17992
1116,bdan_room_15,False,23216,9952,2.333,13264,8290
1117,Bmori1_scene,False,9424,90000,0.105,-80576,8198
1118,Bmori1_room_0,False,28656,56208,0.51,-27552,25997
1119,Bmori1_room_1,False,15088,23408,0.645,-8320,14009
1120,Bmori1_room_2,False,9664,63872,0.151,-54208,7863
1121,Bmori1_room_3,False,9840,14816,0.664,-4976,8434
1122,Bmori1_room_4,False,15328,12992,1.18,2336,11442
1123,Bmori1_room_5,False,103664,13776,7.525,89888,13047
1124,Bmori1_room_6,False,51136,37936,1.348,13200,34884
1125,Bmori1_room_7,False,65168,77792,0.838,-12624,62159
1126,Bmori1_room_8,False,71104,96944,0.733,-25840,64188
1127,Bmori1_room_9,False,49312,41312,1.194,8000,38386
1128,Bmori1_room_10,False,24112,21472,1.123,2640,20914
1129,Bmori1_room_11,False,2320,44000,0.053,-41680,1971
1130,Bmori1_room_12,False,76352,33760,2.262,42592,30682
1131,Bmori1_room_13,False,99584,35504,2.805,64080,33334
1132,Bmori1_room_14,False,53696,23408,2.294,30288,20688
1133,Bmori1_room_15,False,125632,9952,12.624,115680,9348
1134,Bmori1_room_16,False,44304,20384,2.173,23920,18675
1135,Bmori1_room_17,False,65264,37104,1.759,28160,34804
1136,Bmori1_room_18,False,26752,4912,5.446,21840,4385
1137,Bmori1_room_19,False,74592,1280,58.275,73312,1086
1138,Bmori1_room_20,False,41936,4864,8.622,37072,4446
1139,Bmori1_room_21,False,75728,6000,12.621,69728,5331
1140,Bmori1_room_22,False,25088,7648,3.28,17440,7219
1141,HIDAN_scene,False,72112,108496,0.665,-36384,68531
1142,HIDAN_room_0,False,122096,29424,4.15,92672,25898
1143,HIDAN_room_1,False,9840,51504,0.191,-41664,8418
1144,HIDAN_room_2,False,22640,65584,0.345,-42944,16247
1145,HIDAN_room_3,False,9776,9424,1.037,352,8046
1146,HIDAN_room_4,False,22432,30960,0.725,-8528,17188
1147,HIDAN_room_5,False,108912,41696,2.612,67216,37702
1148,HIDAN_room_6,False,29376,28560,1.029,816,25548
1149,HIDAN_room_7,False,51680,14928,3.462,36752,13864
1150,HIDAN_room_8,False,65488,39648,1.652,25840,34923
1151,HIDAN_room_9,False,9440,34672,0.272,-25232,7689
1152,HIDAN_room_10,False,30864,99360,0.311,-68496,26661
1153,HIDAN_room_11,False,41520,14304,2.903,27216,12574
1154,HIDAN_room_12,False,28576,11120,2.57,17456,9722
1155,HIDAN_room_13,False,14816,52112,0.284,-37296,13081
1156,HIDAN_room_14,False,39616,8704,4.551,30912,7361
1157,HIDAN_room_15,False,34672,4496,7.712,30176,3520
1158,HIDAN_room_16,False,99488,47584,2.091,51904,42390
1159,HIDAN_room_17,False,14272,37232,0.383,-22960,12718
1160,HIDAN_room_18,False,11136,15360,0.725,-4224,9425
1161,HIDAN_room_19,False,52192,16944,3.08,35248,14304
1162,HIDAN_room_20,False,8800,27920,0.315,-19120,7174
1163,HIDAN_room_21,False,4560,33920,0.134,-29360,3742
1164,HIDAN_room_22,False,47472,27376,1.734,20096,24520
1165,HIDAN_room_23,False,37184,27936,1.331,9248,24519
1166,HIDAN_room_24,False,15232,21824,0.698,-6592,12089
1167,HIDAN_room_25,False,16864,27360,0.616,-10496,13520
1168,HIDAN_room_26,False,27920,26784,1.042,1136,23859
1169,MIZUsin_scene,False,33984,89136,0.381,-55152,31286
1170,MIZUsin_room_0,False,27392,89136,0.307,-61744,24976
1171,MIZUsin_room_1,False,27936,41424,0.674,-13488,24787
1172,MIZUsin_room_2,False,21824,23696,0.921,-1872,20138
1173,MIZUsin_room_3,False,27360,26560,1.03,800,24228
1174,MIZUsin_room_4,False,26784,24608,1.088,2176,22612
1175,MIZUsin_room_5,False,90000,42560,2.115,47440,40469
1176,MIZUsin_room_6,False,56256,45824,1.228,10432,42261
1177,MIZUsin_room_7,False,23392,21856,1.07,1536,19772
1178,MIZUsin_room_8,False,64048,56704,1.13,7344,52566
1179,MIZUsin_room_9,False,14864,32944,0.451,-18080,12735
1180,MIZUsin_room_10,False,12976,24688,0.526,-11712,10971
1181,MIZUsin_room_11,False,13792,18976,0.727,-5184,12396
1182,MIZUsin_room_12,False,38080,28208,1.35,9872,24996
1183,MIZUsin_room_13,False,77824,2560,30.4,75264,2426
1184,MIZUsin_room_14,False,97136,28288,3.434,68848,26937
1185,MIZUsin_room_15,False,41360,29808,1.388,11552,27909
1186,MIZUsin_room_16,False,21472,15152,1.417,6320,13866
1187,MIZUsin_room_17,False,43984,35504,1.239,8480,31926
1188,MIZUsin_room_18,False,33760,16640,2.029,17120,15437
1189,MIZUsin_room_19,False,35504,14640,2.425,20864,13618
1190,MIZUsin_room_20,False,23472,26688,0.879,-3216,21212
1191,MIZUsin_room_21,False,9872,29856,0.331,-19984,8957
1192,MIZUsin_room_22,False,20384,37104,0.549,-16720,17663
1193,jyasinzou_scene,False,37200,105248,0.353,-68048,34159
1194,jyasinzou_room_0,False,4928,69616,0.071,-64688,4469
1195,jyasinzou_room_1,False,1296,37712,0.034,-36416,970
1196,jyasinzou_room_2,False,4864,23472,0.207,-18608,4304
1197,jyasinzou_room_3,False,6016,15312,0.393,-9296,4833
1198,jyasinzou_room_4,False,7648,29312,0.261,-21664,7163
1199,jyasinzou_room_5,False,55824,98320,0.568,-42496,51114
1200,jyasinzou_room_6,False,86768,18416,4.712,68352,16064
1201,jyasinzou_room_7,False,16720,21776,0.768,-5056,15840
1202,jyasinzou_room_8,False,24112,32944,0.732,-8832,22728
1203,jyasinzou_room_9,False,82336,24016,3.428,58320,21963
1204,jyasinzou_room_10,False,19408,33184,0.585,-13776,18440
1205,jyasinzou_room_11,False,33568,4112,8.163,29456,3438
1206,jyasinzou_room_12,False,20160,8416,2.395,11744,7578
1207,jyasinzou_room_13,False,35088,22704,1.545,12384,20292
1208,jyasinzou_room_14,False,3328,19616,0.17,-16288,2985
1209,jyasinzou_room_15,False,39072,33952,1.151,5120,31730
1210,jyasinzou_room_16,False,19840,25024,0.793,-5184,18523
1211,jyasinzou_room_17,False,29040,38480,0.755,-9440,26433
1212,jyasinzou_room_18,False,14576,23776,0.613,-9200,12657
1213,jyasinzou_room_19,False,78096,24016,3.252,54080,22785
1214,jyasinzou_room_20,False,75712,33216,2.279,42496,31253
1215,jyasinzou_room_21,False,94688,18016,5.256,76672,16951
1216,jyasinzou_room_22,False,28880,12400,2.329,16480,11011
1217,jyasinzou_room_23,False,7008,37392,0.187,-30384,5399
1218,jyasinzou_room_24,False,162944,25808,6.314,137136,23418
1219,jyasinzou_room_25,False,2432,88992,0.027,-86560,1957
1220,jyasinzou_room_26,False,199824,51968,3.845,147856,45640
1221,jyasinzou_room_27,False,89328,22288,4.008,67040,19511
1222,jyasinzou_room_28,False,89216,35376,2.522,53840,32233
1223,HAKAdan_scene,False,41312,99264,0.416,-57952,38444
1224,HAKAdan_room_0,False,23440,45392,0.516,-21952,22259
1225,HAKAdan_room_1,False,26384,6896,3.826,19488,5897
1226,HAKAdan_room_2,False,24544,43488,0.564,-18944,23334
1227,HAKAdan_room_3,False,42480,10624,3.998,31856,9369
1228,HAKAdan_room_4,False,45760,7264,6.3,38496,6500
1229,HAKAdan_room_5,False,21840,23232,0.94,-1392,20647
1230,HAKAdan_room_6,False,56528,30192,1.872,26336,27242
1231,HAKAdan_room_7,False,32736,6880,4.758,25856,5998
1232,HAKAdan_room_8,False,24496,20640,1.187,3856,18505
1233,HAKAdan_room_9,False,18864,52368,0.36,-33504,18221
1234,HAKAdan_room_10,False,28048,30704,0.913,-2656,25117
1235,HAKAdan_room_11,False,2560,15968,0.16,-13408,2408
1236,HAKAdan_room_12,False,28256,22352,1.264,5904,19429
1237,HAKAdan_room_13,False,29744,4128,7.205,25616,3623
1238,HAKAdan_room_14,False,15056,22784,0.661,-7728,14035
1239,HAKAdan_room_15,False,35360,29376,1.204,5984,25482
1240,HAKAdan_room_16,False,16576,10544,1.572,6032,9298
1241,HAKAdan_room_17,False,14640,11744,1.247,2896,10944
1242,HAKAdan_room_18,False,26432,54032,0.489,-27600,24323
1243,HAKAdan_room_19,False,29856,11648,2.563,18208,10868
1244,HAKAdan_room_20,False,37104,7744,4.791,29360,6560
1245,HAKAdan_room_21,False,3264,46512,0.07,-43248,2730
1246,HAKAdan_room_22,False,179248,10672,16.796,168576,9583
1247,HAKAdanCH_scene,False,55328,50576,1.094,4752,46849
1248,HAKAdanCH_room_0,False,29344,87840,0.334,-58496,27239
1249,HAKAdanCH_room_1,False,20880,45360,0.46,-24480,19578
1250,HAKAdanCH_room_2,False,10432,12640,0.825,-2208,9209
1251,HAKAdanCH_room_3,False,20784,7360,2.824,13424,6462
1252,HAKAdanCH_room_4,False,31072,9376,3.314,21696,8577
1253,HAKAdanCH_room_5,False,18144,10640,1.705,7504,9798
1254,HAKAdanCH_room_6,False,23152,11936,1.94,11216,11257
1255,ice_doukutu_scene,False,16336,71360,0.229,-55024,15264
1256,ice_doukutu_room_0,False,13872,34432,0.403,-20560,12931
1257,ice_doukutu_room_1,False,23248,50480,0.461,-27232,22081
1258,ice_doukutu_room_2,False,23088,23296,0.991,-208,21809
1259,ice_doukutu_room_3,False,34480,32912,1.048,1568,31144
1260,ice_doukutu_room_4,False,32336,30288,1.068,2048,28922
1261,ice_doukutu_room_5,False,28368,34944,0.812,-6576,26721
1262,ice_doukutu_room_6,False,992,16816,0.059,-15824,811
1263,ice_doukutu_room_7,False,154480,22768,6.785,131712,22432
1264,ice_doukutu_room_8,False,88000,6432,13.682,81568,5865
1265,ice_doukutu_room_9,False,16496,34448,0.479,-17952,14881
1266,ice_doukutu_room_10,False,24208,17376,1.393,6832,15943
1267,ice_doukutu_room_11,False,37328,22608,1.651,14720,21052
1268,men_scene,False,29024,70848,0.41,-41824,27127
1269,men_room_0,False,16464,65424,0.252,-48960,14268
1270,men_room_1,False,24608,37488,0.656,-12880,22456
1271,men_room_2,False,16960,20560,0.825,-3600,15257
1272,men_room_3,False,13600,31824,0.427,-18224,11981
1273,men_room_4,False,14464,41440,0.349,-26976,11986
1274,men_room_5,False,15472,20512,0.754,-5040,13613
1275,men_room_6,False,14384,32640,0.441,-18256,11702
1276,men_room_7,False,14336,33472,0.428,-19136,11539
1277,men_room_8,False,15568,33328,0.467,-17760,12839
1278,men_room_9,False,11088,14448,0.767,-3360,10231
1279,men_room_10,False,25056,23632,1.06,1424,22797
1280,ganontika_scene,False,9952,137168,0.073,-127216,8735
1281,ganontika_room_0,False,99264,37392,2.655,61872,33315
1282,ganontika_room_1,False,45248,117200,0.386,-71952,39697
1283,ganontika_room_2,False,6848,30688,0.223,-23840,6095
1284,ganontika_room_3,False,43280,39488,1.096,3792,36987
1285,ganontika_room_4,False,10560,31888,0.331,-21328,9354
1286,ganontika_room_5,False,7232,29984,0.241,-22752,6656
1287,ganontika_room_6,False,23136,64608,0.358,-41472,20904
1288,ganontika_room_7,False,30064,31888,0.943,-1824,26637
1289,ganontika_room_8,False,6832,36896,0.185,-30064,6051
1290,ganontika_room_9,False,20576,47136,0.437,-26560,18296
1291,ganontika_room_10,False,52064,27584,1.887,24480,26467
1292,ganontika_room_11,False,30624,26960,1.136,3664,24191
1293,ganontika_room_12,False,15680,45680,0.343,-30000,14749
1294,ganontika_room_13,False,22304,32064,0.696,-9760,19829
1295,ganontika_room_14,False,4016,41424,0.097,-37408,3595
1296,ganontika_room_15,False,22848,32064,0.713,-9216,20324
1297,ganontika_room_16,False,29296,11824,2.478,17472,10690
1298,ganontika_room_17,False,10368,34336,0.302,-23968,9091
1299,ganontika_room_18,False,11472,50912,0.225,-39440,10340
1300,ganontika_room_19,False,53888,32064,1.681,21824,29347
1301,market_day_scene,False,8288,9840,0.842,-1552,7233
1302,market_day_room_0,False,22608,22640,0.999,-32,19815
1303,market_night_scene,False,19600,9776,2.005,9824,8360
1304,market_night_room_0,False,33904,22432,1.511,11472,19101
1305,testroom_scene,,16896,,,,
1306,testroom_room_0,,17920,,,,
1307,testroom_room_1,,9200,,,,
1308,testroom_room_2,,12928,,,,
1309,testroom_room_3,,14880,,,,
1310,testroom_room_4,,768,,,,
1311,kenjyanoma_scene,False,24976,14576,1.714,10400,12394
1312,kenjyanoma_room_0,False,38416,78096,0.492,-39680,37041
1313,tokinoma_scene,False,23728,75680,0.314,-51952,21999
1314,tokinoma_room_0,False,24032,94688,0.254,-70656,22006
1315,tokinoma_room_1,False,33216,28880,1.15,4336,26523
1316,sutaru_scene,,2992,,,,
1317,sutaru_room_0,,29424,,,,
1318,link_home_scene,False,18000,7008,2.568,10992,5874
1319,link_home_room_0,False,12496,162944,0.077,-150448,10797
1320,kokiri_shop_scene,False,37264,2432,15.322,34832,1958
1321,kokiri_shop_room_0,False,25776,199824,0.129,-174048,22704
1322,kokiri_home_scene,False,88944,3264,27.25,85680,2680
1323,kokiri_home_room_0,False,52000,179248,0.29,-127248,46074
1324,kakusiana_scene,False,22208,55328,0.401,-33120,20812
1325,kakusiana_room_0,False,35360,29344,1.205,6016,27835
1326,kakusiana_room_1,False,71168,20880,3.408,50288,19758
1327,kakusiana_room_2,False,34400,10432,3.298,23968,9587
1328,kakusiana_room_3,False,50496,20784,2.43,29712,19064
1329,kakusiana_room_4,False,23280,31072,0.749,-7792,22323
1330,kakusiana_room_5,False,32896,18144,1.813,14752,17241
1331,kakusiana_room_6,False,30320,23152,1.31,7168,21664
1332,kakusiana_room_7,False,34960,16336,2.14,18624,15195
1333,kakusiana_room_8,False,16992,13872,1.225,3120,12632
1334,kakusiana_room_9,False,22768,23248,0.979,-480,21586
1335,kakusiana_room_10,False,6480,23088,0.281,-16608,5659
1336,kakusiana_room_11,False,34384,34480,0.997,-96,32441
1337,kakusiana_room_12,False,17376,32336,0.537,-14960,16478
1338,kakusiana_room_13,False,22784,28368,0.803,-5584,21304
1339,entra_scene,False,1648,992,1.661,656,601
1340,entra_room_0,False,189008,154480,1.224,34528,50550
1341,moribossroom_scene,False,3744,6400,0.585,-2656,3085
1342,moribossroom_room_0,False,176064,24256,7.259,151808,21462
1343,moribossroom_room_1,False,3648,55984,0.065,-52336,3205
1344,syatekijyou_scene,False,12320,49856,0.247,-37536,11202
1345,syatekijyou_room_0,False,20672,30448,0.679,-9776,17587
1346,shop1_scene,False,19456,752,25.872,18704,485
1347,shop1_room_0,False,17008,169904,0.1,-152896,13004
1348,hairal_niwa_scene,False,28640,70544,0.406,-41904,26164
1349,hairal_niwa_room_0,False,1296,43232,0.03,-41936,989
1350,ganon_tou_scene,False,169376,19312,8.771,150064,17151
1351,ganon_tou_room_0,False,57344,80624,0.711,-23280,54025
1352,sasatest_scene,,11040,,,,
1353,sasatest_room_0,,13904,,,,
1354,market_alley_scene,False,14608,4688,3.116,9920,3959
1355,market_alley_room_0,False,2704,481024,0.006,-478320,2579
1356,spot20_scene,False,30928,73248,0.422,-42320,29029
1357,spot20_room_0,False,34832,26320,1.323,8512,24207
1358,market_ruins_scene,False,17104,5680,3.011,11424,4822
1359,market_ruins_room_0,False,52640,10272,5.125,42368,7232
1360,entra_n_scene,False,16400,1072,15.299,15328,762
1361,entra_n_room_0,False,928,154480,0.006,-153552,666
1362,enrui_scene,False,156112,992,157.371,155120,722
1363,enrui_room_0,False,912,154464,0.006,-153552,607
1364,market_alley_n_scene,False,156128,4848,32.205,151280,4061
1365,market_alley_n_room_0,False,1008,481008,0.002,-480000,886
1366,hiral_demo_scene,False,179808,15696,11.456,164112,11373
1367,hiral_demo_room_0,False,1456,1600,0.91,-144,951
1368,kokiri_home3_scene,False,158768,6048,26.251,152720,4435
1369,kokiri_home3_room_0,False,1648,222736,0.007,-221088,904
1370,malon_stable_scene,False,166240,1648,100.874,164592,983
1371,malon_stable_room_0,False,3344,189008,0.018,-185664,2260
1372,kakariko_scene,False,159648,3744,42.641,155904,2490
1373,kakariko_room_0,False,3824,176064,0.022,-172240,2702
1374,bdan_boss_scene,False,182000,3648,49.89,178352,2764
1375,bdan_boss_room_0,False,1664,12320,0.135,-10656,1397
1376,bdan_boss_room_1,False,210592,20672,10.187,189920,16641
1377,FIRE_bs_scene,False,14880,19456,0.765,-4576,11784
1378,FIRE_bs_room_0,False,97984,17008,5.761,80976,14772
1379,FIRE_bs_room_1,False,10336,28640,0.361,-18304,9700
1380,hut_scene,False,20016,1296,15.444,18720,1040
1381,hut_room_0,False,15840,169376,0.094,-153536,14379
1382,daiyousei_izumi_scene,False,5952,57344,0.104,-51392,5362
1383,daiyousei_izumi_room_0,False,28656,14608,1.962,14048,13413
1384,hakaana_scene,False,26608,2704,9.84,23904,2330
1385,hakaana_room_0,False,10112,30928,0.327,-20816,9255
1386,yousei_izumi_tate_scene,False,10720,34832,0.308,-24112,9675
1387,yousei_izumi_tate_room_0,False,24400,17104,1.427,7296,14805
1388,yousei_izumi_yoko_scene,False,6752,52640,0.128,-45888,5132
1389,yousei_izumi_yoko_room_0,False,17520,16400,1.068,1120,15190
1390,golon_scene,False,45808,928,49.362,44880,764
1391,golon_room_0,False,67504,156112,0.432,-88608,56063
1392,zoora_scene,False,32464,912,35.596,31552,680
1393,zoora_room_0,False,30576,156128,0.196,-125552,27968
1394,drag_scene,False,30800,1008,30.556,29792,774
1395,drag_room_0,False,30512,179808,0.17,-149296,24961
1396,alley_shop_scene,False,37072,1456,25.462,35616,1215
1397,alley_shop_room_0,False,35600,158768,0.224,-123168,32522
1398,night_shop_scene,False,39840,1648,24.175,38192,1373
1399,night_shop_room_0,False,42912,166240,0.258,-123328,36698
1400,impa_scene,False,27616,3344,8.258,24272,2855
1401,impa_room_0,False,22816,159648,0.143,-136832,20160
1402,labo_scene,False,31776,3824,8.31,27952,2667
1403,labo_room_0,False,24192,182000,0.133,-157808,16846
1404,tent_scene,False,36080,1664,21.683,34416,1269
1405,tent_room_0,False,4048,210592,0.019,-206544,3474
1406,nakaniwa_scene,False,32320,14880,2.172,17440,12701
1407,nakaniwa_room_0,False,15808,97984,0.161,-82176,14788
1408,ddan_boss_scene,False,46848,10336,4.533,36512,9678
1409,ddan_boss_room_0,False,6832,20016,0.341,-13184,5901
1410,ddan_boss_room_1,False,231760,15840,14.631,215920,15624
1411,ydan_boss_scene,False,5136,5952,0.863,-816,4354
1412,ydan_boss_room_0,False,200544,28656,6.998,171888,28403
1413,ydan_boss_room_1,False,74112,26608,2.785,47504,25674
1414,HAKAdan_bs_scene,False,52912,10112,5.233,42800,9512
1415,HAKAdan_bs_room_0,False,2112,10720,0.197,-8608,1627
1416,HAKAdan_bs_room_1,False,173440,24400,7.108,149040,21697
1417,MIZUsin_bs_scene,False,57968,6752,8.585,51216,4839
1418,MIZUsin_bs_room_0,False,29376,17520,1.677,11856,16931
1419,MIZUsin_bs_room_1,False,26400,45808,0.576,-19408,23509
1420,ganon_scene,False,33968,67504,0.503,-33536,32585
1421,ganon_room_0,False,36064,32464,1.111,3600,28511
1422,ganon_room_1,False,17536,30576,0.574,-13040,15938
1423,ganon_room_2,False,17488,30800,0.568,-13312,16103
1424,ganon_room_3,False,31408,30512,1.029,896,27688
1425,ganon_room_4,False,5344,37072,0.144,-31728,4641
1426,ganon_room_5,False,338672,35600,9.513,303072,29626
1427,ganon_room_6,False,75488,39840,1.895,35648,38415
1428,ganon_room_7,False,26464,42912,0.617,-16448,21567
1429,ganon_room_8,False,5376,27616,0.195,-22240,4594
1430,ganon_room_9,False,338704,22816,14.845,315888,19994
1431,ganon_boss_scene,False,5264,31776,0.166,-26512,4010
1432,ganon_boss_room_0,False,338672,24192,13.999,314480,18134
1433,jyasinboss_scene,False,137152,36080,3.801,101072,32909
1434,jyasinboss_room_0,False,37312,4048,9.217,33264,3599
1435,jyasinboss_room_1,False,117168,32320,3.625,84848,29919
1436,jyasinboss_room_2,False,30688,15808,1.941,14880,14475
1437,jyasinboss_room_3,False,39312,46848,0.839,-7536,36821
1438,kokiri_home4_scene,False,31888,6832,4.667,25056,5806
1439,kokiri_home4_room_0,False,30016,231760,0.13,-201744,29744
1440,kokiri_home5_scene,False,64496,5136,12.558,59360,4235
1441,kokiri_home5_room_0,False,31888,200544,0.159,-168656,31608
1442,ganon_final_scene,False,36976,74112,0.499,-37136,35956
1443,ganon_final_room_0,False,47248,52912,0.893,-5664,41444
1444,kakariko3_scene,False,27504,2112,13.023,25392,1711
1445,kakariko3_room_0,False,26960,173440,0.155,-146480,23051
1446,hairal_niwa2_scene,,11536,,,,
1447,hairal_niwa2_room_0,,97280,,,,
1448,hakasitarelay_scene,False,45936,57968,0.792,-12032,43624
1449,hakasitarelay_room_0,False,32064,29376,1.092,2688,28246
1450,hakasitarelay_room_1,False,41376,26400,1.567,14976,24232
1451,hakasitarelay_room_2,False,32064,33968,0.944,-1904,30015
1452,hakasitarelay_room_3,False,11808,36064,0.327,-24256,11004
1453,hakasitarelay_room_4,False,34464,17536,1.965,16928,15979
1454,hakasitarelay_room_5,False,50800,17488,2.905,33312,15986
1455,hakasitarelay_room_6,False,32064,31408,1.021,656,28612
1456,shrine_scene,False,53392,5344,9.991,48048,4546
1457,shrine_room_0,False,26640,338672,0.079,-312032,20945
1458,turibori_scene,False,55584,75488,0.736,-19904,53261
1459,turibori_room_0,False,19776,26464,0.747,-6688,17729
1460,shrine_n_scene,False,29360,5376,5.461,23984,4578
1461,shrine_n_room_0,False,15952,338704,0.047,-322752,12982
1462,shrine_r_scene,False,45840,5264,8.708,40576,4728
1463,shrine_r_room_0,False,14624,338672,0.043,-324048,11758
1464,hakaana2_scene,False,20032,53392,0.375,-33360,18398
1465,hakaana2_room_0,False,50528,26640,1.897,23888,23512
1466,gerudoway_scene,False,87536,55584,1.575,31952,51007
1467,gerudoway_room_0,False,45776,19776,2.315,26000,17918
1468,gerudoway_room_1,False,12688,29360,0.432,-16672,10788
1469,gerudoway_room_2,False,7264,15952,0.455,-8688,5946
1470,gerudoway_room_3,False,9296,45840,0.203,-36544,8315
1471,gerudoway_room_4,False,10592,14624,0.724,-4032,9941
1472,gerudoway_room_5,False,11904,20032,0.594,-8128,10974
1473,hairal_niwa_n_scene,False,37104,37104,1.0,0,4
1474,hairal_niwa_n_room_0,True,13856,13856,1.0,0,0
1475,bowling_scene,False,60192,60192,1.0,0,4
1476,bowling_room_0,True,25056,25056,1.0,0,0
1477,hakaana_ouke_scene,False,19168,19168,1.0,0,36
1478,hakaana_ouke_room_0,True,43008,43008,1.0,0,0
1479,hakaana_ouke_room_1,True,18432,18432,1.0,0,0
1480,hakaana_ouke_room_2,True,24848,24848,1.0,0,0
1481,hylia_labo_scene,False,69776,69776,1.0,0,4
1482,hylia_labo_room_0,True,30160,30160,1.0,0,0
1483,souko_scene,False,27664,27664,1.0,0,12
1484,souko_room_0,True,38208,38208,1.0,0,0
1485,souko_room_1,True,42032,42032,1.0,0,0
1486,souko_room_2,True,33152,33152,1.0,0,0
1487,miharigoya_scene,False,50512,50512,1.0,0,8
1488,miharigoya_room_0,True,15792,15792,1.0,0,0
1489,mahouya_scene,False,43552,43552,1.0,0,4
1490,mahouya_room_0,True,27280,27280,1.0,0,0
1491,takaraya_scene,False,29104,29104,1.0,0,28
1492,takaraya_room_0,True,40384,40384,1.0,0,0
1493,takaraya_room_1,True,8192,8192,1.0,0,0
1494,takaraya_room_2,True,8240,8240,1.0,0,0
1495,takaraya_room_3,True,10272,10272,1.0,0,0
1496,takaraya_room_4,True,12320,12320,1.0,0,0
1497,takaraya_room_5,True,12288,12288,1.0,0,0
1498,takaraya_room_6,True,11008,11008,1.0,0,0
1499,ganon_sonogo_scene,False,32528,32528,1.0,0,20
1500,ganon_sonogo_room_0,True,32384,32384,1.0,0,0
1501,ganon_sonogo_room_1,True,31664,31664,1.0,0,0
1502,ganon_sonogo_room_2,True,36000,36000,1.0,0,0
1503,ganon_sonogo_room_3,True,22080,22080,1.0,0,0
1504,ganon_sonogo_room_4,True,36080,36080,1.0,0,0
1505,ganon_demo_scene,False,36976,36976,1.0,0,8
1506,ganon_demo_room_0,True,16720,16720,1.0,0,0
1507,besitu_scene,,1200,,,,
1508,besitu_room_0,,21728,,,,
1509,face_shop_scene,False,880,880,1.0,0,4
1510,face_shop_room_0,True,190016,190016,1.0,0,0
1511,kinsuta_scene,False,5648,5648,1.0,0,4
1512,kinsuta_room_0,True,57504,57504,1.0,0,0
1513,ganontikasonogo_scene,False,19200,19200,1.0,0,8
1514,ganontikasonogo_room_0,True,97152,97152,1.0,0,0
1515,ganontikasonogo_room_1,True,40736,40736,1.0,0,0
1516,test01_scene,,15904,,,,
1517,test01_room_0,,39152,,,,
1518,bump_texture_static,True,1024,1024,1.0,0,0
1519,anime_model_1_static,True,16,16,1.0,0,0
1520,anime_model_2_static,True,16,16,1.0,0,0
1521,anime_model_3_static,True,16,16,1.0,0,0
1522,anime_model_4_static,True,16,16,1.0,0,0
1523,anime_model_5_static,True,16,16,1.0,0,0
1524,anime_model_6_static,True,16,16,1.0,0,0
1525,anime_texture_1_static,True,16,16,1.0,0,0
1526,anime_texture_2_static,True,16,16,1.0,0,0
1527,anime_texture_3_static,True,16,16,1.0,0,0
1528,anime_texture_4_static,True,16,16,1.0,0,0
1529,anime_texture_5_static,True,16,16,1.0,0,0
1530,anime_texture_6_static,True,16,16,1.0,0,0
1531,softsprite_matrix_static,True,64,64,1.0,0,0
